1 Мая вуліца 	1 Мая улица 	вуліца
17 Верасня вуліца 	17 Сентября улица 	вуліца
1-ы Васточны завулак 	1-й Восточный переулок 	завулак
8 Сакавіка вуліца 	8 Сакавика улица 	вуліца
А.Кашавога вуліца 	О.Кошевого улица 	вуліца
Альпяровіча вуліца 	Альперовича улица 	вуліца
Анатоля Рогача вуліца 	Анатолия Рогача улица 	вуліца
Асенняя вуліца 	Осенняя улица 	вуліца
Асланава вуліца 	Асланова улица 	вуліца
Астроўскага вуліца 	Островского улица 	вуліца
Багдановіча вуліца 	Богдановича улица 	вуліца
Берагавы завулак 	Береговой переулок 	завулак
Будаўнiкоў вуліца 	Строителей улица 	вуліца
Бутрымаўская вуліца 	Бутримовская улица 	вуліца
Бярозавы завулак 	Берёзовый переулок 	завулак
В.Харужай вуліца 	В.Хоружей улица 	вуліца
Вадап'янава вуліца 	Водопьянова улица 	вуліца
Валынца вуліца 	Волынца улица 	вуліца
Ведаў вуліца 	Ведов улица 	вуліца
Вілейская вуліца 	Вилейская улица 	вуліца
Вішнёвы завулак 	Вишневый переулок 	завулак
Волкава вуліца 	Волкова улица 	вуліца
Вясенні завулак 	Весенний переулок 	завулак
Вясенняя вуліца 	Весенняя улица 	вуліца
Вясковая вуліца 	Весковая улица 	вуліца
Гагарына вуліца 	Гагарина улица 	вуліца
Ганны Новік вуліца 	Анны Новик улица 	вуліца
Гарадзішчанская вуліца 	Городищенская улица 	вуліца
Гарбузава завулак 	Гарбузова переулок 	завулак
Гастэлы вуліца 	Гастелло улица 	вуліца
Георгіеўская вуліца 	Георгиевская улица 	вуліца
Гідрабудаўнікоў завулак 	Гидростроителей переулок 	завулак
Гістарычная вуліца 	Гисторичная улица 	вуліца
Гістарычны завулак 	Гисторичный переулок 	завулак
Гурыновіча вуліца 	Гуриновича улица 	вуліца
Дабравольскага вуліца 	Добровольского улица 	вуліца
Даўгінаўская вуліца 	Долгиновская улица 	вуліца
Дзяржынскага вуліца 	Дзержинского улица 	вуліца
Добрай Волі вуліца 	Доброй Воли улица 	вуліца
Дружбы вуліца 	Дружбы улица 	вуліца
Жалігоўскага вуліца 	Жалиговского улица 	вуліца
Жоўткі вуліца 	Желтко улица 	вуліца
З.Касмадзям'янскай вуліца 	З.Космодемьянской улица 	вуліца
Заазёрная вуліца 	Заозерная улица 	вуліца
Зарэчная вуліца 	Заречная улица 	вуліца
Заслонава вуліца 	Заслонова улица 	вуліца
Зорная вуліца 	Звёздная улица 	вуліца
Зубовіча вуліца 	Зубовича улица 	вуліца
Зялёная вуліца 	Зелёная улица 	вуліца
Зялёны завулак 	Зелёный переулок 	завулак
Івана Лашуткі вуліца 	Ивана Лашутко улица 	вуліца
Ігнація Ходзькі вуліца 	Игнатия Ходьки улица 	вуліца
Інтэрнацыянальная вуліца 	Интернациональная улица 	вуліца
Калгасны завулак 	Колхозный переулок 	завулак
Камарова вуліца 	Комарова улица 	вуліца
Камсамольская вуліца 	Комсомольская улица 	вуліца
Каралёва вуліца 	Королёва улица 	вуліца
Каралёва завулак 	Королёва переулок 	завулак
Касманаўтаў вуліца 	Космонавтов улица 	вуліца
Касманаўтаў завулак 	Космонавтов переулок 	завулак
Кастрычніцкая вуліца 	Октябрьская улица 	вуліца
Красіна вуліца 	Красина улица 	вуліца
Крывіцкая вуліца 	Кривичская улица 	вуліца
Крывіцкі завулак 	Кривичский переулок 	завулак
Крынiчная вуліца 	Родниковая улица 	вуліца
Крынічны завулак 	Родниковый переулок 	завулак
Куранецкая вуліца 	Куренецкая улица 	вуліца
Л.Талстога вуліца 	Л.Толстого улица 	вуліца
Лаўрыновіча вуліца 	Лавриновича улица 	вуліца
Лаўрыновіча завулак 	Лавриновича переулок 	завулак
Летняя вуліца 	Летняя улица 	вуліца
Лугавы 1-ы завулак 	Луговой 1-й переулок 	завулак
Лугавы 2-і завулак 	Луговой 2-й переулок 	завулак
Лугавы 3-і завулак 	Луговой 3-й переулок 	завулак
Любанская вуліца 	Любанская улица 	вуліца
Лясны завулак 	Лесной переулок 	завулак
М.Горкага вуліца 	М.Горького улица 	вуліца
М.Казея вуліца 	М.Казея улица 	вуліца
Макаўе вуліца 	Маковье улица 	вуліца
Максіма Танка вуліца 	Максима Танка улица 	вуліца
Маладзёжная вуліца 	Молодёжная улица 	вуліца
Маліноўскага завулак 	Малиновского переулок 	завулак
Маркава вуліца 	Маркова улица 	вуліца
Матросава завулак 	Матросова переулок 	завулак
Машэрава вуліца 	Машерова улица 	вуліца
Маякоўскага вуліца 	Маяковского улица 	вуліца
Маякоўскага завулак 	Маяковского переулок 	завулак
Меліяратараў вуліца 	Мелиораторов улица 	вуліца
Мірная вуліца 	Мирная улица 	вуліца
Молакава вуліца 	Молокова улица 	вуліца
Н.Каляды вуліца 	Н.Коледы улица 	вуліца
Набярэжная вуліца 	Набережная улица 	вуліца
Набярэжны завулак 	Набережный переулок 	завулак
Навасёлаў вуліца 	Новосёлов улица 	вуліца
Нарачанская вуліца 	Нарочанская улица 	вуліца
Нарачанскі 1-ы завулак 	Нарочанский 1-й переулок 	завулак
Нарачанскі 2-і завулак 	Нарочанский 2-й переулок 	завулак
Незалежнасці вуліца 	Незалежности улица 	вуліца
Нікалаева вуліца 	Николаева улица 	вуліца
Новая вуліца 	Новая улица 	вуліца
Някрасава вуліца 	Некрасова улица 	вуліца
П.Купрыянава вуліца 	П.Куприянова улица 	вуліца
Палявы 1-ы завулак 	Полевой 1-й переулок 	завулак
Палявы 2-і завулак 	Полевой 2-й переулок 	завулак
Палявы завулак 	Полевой переулок 	завулак
Партызанская вуліца 	Партизанская улица 	вуліца
Партызанскі завулак 	Партизанский переулок 	завулак
Пасёлак Рабочы вуліца 	Посёлок Рабочий улица 	вуліца
Пасёлак Рабочы завулак 	Посёлок Рабочий переулок 	завулак
Пасёлак Чапаева вуліца 	Посёлок Чапаева улица 	вуліца
Паўночная вуліца 	Повночная улица 	вуліца
Пацаева вуліца 	Пацаева улица 	вуліца
Перспектыўная вуліца 	Перспективная улица 	вуліца
Піліпа Орліка вуліца 	Пилипа Орлика улица 	вуліца
Піянерская вуліца 	Пионерская улица 	вуліца
Пляснянская вуліца 	Плеснянская улица 	вуліца
Прамысловая вуліца 	Промысловая улица 	вуліца
Прамысловы 1-ы завулак 	Промысловый 1-й переулок 	завулак
Прамысловы 2-і завулак 	Промысловый 2-й переулок 	завулак
Прывакзальная вуліца 	Привокзальная улица 	вуліца
Пушкіна вуліца 	Пушкина улица 	вуліца
Пушкіна завулак 	Пушкина переулок 	завулак
Рабочая вуліца 	Рабочая улица 	вуліца
Рабочы 1-ы завулак 	Рабочий 1-й переулок 	завулак
Рабочы 2-і завулак 	Рабочий 2-й переулок 	завулак
Рабочы завулак 	Рабочий переулок 	завулак
Рачны завулак 	Речной переулок 	завулак
Ручавая вуліца 	Ручевая улица 	вуліца
Савецкая вуліца 	Советская улица 	вуліца
Савецкі завулак 	Советский переулок 	завулак
Садовая вуліца 	Садовая улица 	вуліца
Сасновая вуліца 	Сосновая улица 	вуліца
Сасновы 1-ы завулак 	Сосновый 1-й переулок 	завулак
Сасновы 2-і завулак 	Сосновый 2-й переулок 	завулак
Сасновы завулак 	Сосновый переулок 	завулак
Сацыялістычная вуліца 	Социалистическая улица 	вуліца
Свабоды вуліца 	Свободы улица 	вуліца
Свабоды плошча 	Свободы площадь 	плошча
Севера-Западная вуліца 	Северо - Западная улица 	вуліца
Сельская вуліца 	Сельская улица 	вуліца
Сельскі 1-ы завулак 	Сельский 1-й переулок 	завулак
Сельскі 2-і завулак 	Сельский 2-й переулок 	завулак
Сілівановіча вуліца 	Силивановича улица 	вуліца
Слабадская вуліца 	Слободская улица 	вуліца
Слабадскі завулак 	Слободской переулок 	завулак
Смаргонская вуліца 	Сморгонская улица 	вуліца
Снежкаўская вуліца 	Снежковская улица 	вуліца
Снежкаўскі завулак 	Снежковский переулок 	завулак
Сонечная вуліца 	Солнечная улица 	вуліца
Стаўкі вуліца 	Ставки улица 	вуліца
Стаўкі завулак 	Ставки переулок 	завулак
Стаханаўская вуліца 	Стахановская улица 	вуліца
Стаханаўскі завулак 	Стахановский переулок 	завулак
Усходні 2-і завулак 	Восточный 2-й переулок 	завулак
Усходні завулак 	Восточный переулок 	завулак
Усходняя вуліца 	Восточная улица 	вуліца
Фрунзэ вуліца 	Фрунзе улица 	вуліца
Фрунзэ завулак 	Фрунзе переулок 	завулак
Хвойная вуліца 	Хвойная улица 	вуліца
Цвяточная вуліца 	Цветочная улица 	вуліца
Церашковай вуліца 	Терешковой улица 	вуліца
Цяністая вуліца 	Тенистая улица 	вуліца
Цяністы 1-ы завулак 	Тенистый 1-й переулок 	завулак
Цяністы 2-і завулак 	Тенистый 2-й переулок 	завулак
Чайкоўскага вуліца 	Чайковского улица 	вуліца
Чайкоўскага завулак 	Чайковского переулок 	завулак
Чапаева вуліца 	Чапаева улица 	вуліца
Чарняева завулак 	Черняева переулок 	завулак
Чарняхоўскага вуліца 	Черняховского улица 	вуліца
Чарняхоўскага завулак 	Черняховского переулок 	завулак
Чкалава вуліца 	Чкалова улица 	вуліца
Чырвонаармейская вуліца 	Красноармейская улица 	вуліца
Шаталава вуліца 	Шаталова улица 	вуліца
Школьны завулак 	Школьный переулок 	завулак
Шубіна вуліца 	Шубина улица 	вуліца
Энергетыкаў вуліца 	Энергетиков улица 	вуліца
Юбілейная вуліца 	Юбилейная улица 	вуліца
Я.Коласа вуліца 	Я.Коласа улица 	вуліца
Я.Купалы вуліца 	Я.Купалы улица 	вуліца
Яблыневая вуліца 	Яблоневая улица 	вуліца
Ясная вуліца 	Ясная улица 	вуліца
Ясны завулак 	Ясный переулок 	завулак