1 Ліпеня вуліца 	1 Июля улица 	вуліца
1 Мая вуліца 	1 Мая улица 	вуліца
1-й Маскоўскай Дывізіі вуліца 	1-й Московской Дивизии улица 	вуліца
3-га Інтэрнацыянала вуліца 	3-го Интернационала улица 	вуліца
8 Сакавіка вуліца 	8 Марта улица 	вуліца
10 год БССР вуліца 	10 лет БССР улица 	вуліца
30 год БССР вуліца 	30 лет БССР улица 	вуліца
30 год ВЛКСМ вуліца 	30 лет ВЛКСМ улица 	вуліца
50 год БССР вуліца 	50 лет БССР улица 	вуліца
1812 года вуліца 	1812 года улица 	вуліца
Аб’язная дарога 	Объездная дорога 	дарога
Авіяцыйны завулак 	Авиационный переулок 	завулак
Агранамічная вуліца 	Агрономическая улица 	вуліца
Агранамічны завулак 	Агрономический переулок 	завулак
Адамовіча вуліца 	Адамовича улица 	вуліца
Азёрная вуліца 	Озёрная улица 	вуліца
Акадэмічны завулак 	Академический переулок 	завулак
Акружная вуліца 	Окружная улица 	вуліца
Акружны 1-ы завулак 	Окружной 1-й переулок 	завулак
Акружны 2-і завулак 	Окружной 2-й переулок 	завулак
Акружны 3-і завулак 	Окружной 3-й переулок 	завулак
Акружны 4-ы завулак 	Окружной 4-й переулок 	завулак
Акружны 5-ы завулак 	Окружной 5-й переулок 	завулак
Акружны 6-ы завулак 	Окружной 6-й переулок 	завулак
Акружны 7-ы завулак 	Окружной 7-й переулок 	завулак
Акружны 8-ы завулак 	Окружной 8-й переулок 	завулак
Алега Кашавога вуліца 	Олега Кошевого улица 	вуліца
Андрэева завулак 	Андреева переулок 	завулак
Аранжарэйная вуліца 	Оранжерейная улица 	вуліца
Арджанікідзэ праспект 	Орджоникидзе проспект 	праспект
Аршанская вуліца 	Оршанская улица 	вуліца
Аршанскі завулак 	Оршанский переулок 	завулак
Асаавіяхіма завулак 	Осоавиахима переулок 	завулак
Асіпенкі вуліца 	Осипенко улица 	вуліца
Асіпенкі завулак 	Осипенко переулок 	завулак
Асіпенкі 1-ы завулак 	Осипенко 1-й переулок 	завулак
Асіпенкі 2-і завулак 	Осипенко 2-й переулок 	завулак
Асіпенкі 3-і завулак 	Осипенко 3-й переулок 	завулак
Асіпенкі 4-ы завулак 	Осипенко 4-й переулок 	завулак
Асіпенкі 5-ы завулак 	Осипенко 5-й переулок 	завулак
Асіпенкі 6-ы завулак 	Осипенко 6-й переулок 	завулак
Асіпенкі 7-ы завулак 	Осипенко 7-й переулок 	завулак
Асіпенкі 8-ы завулак 	Осипенко 8-й переулок 	завулак
Асіпенкі 9-ы завулак 	Осипенко 9-й переулок 	завулак
Астроўскага вуліца 	Островского улица 	вуліца
Астроўскага 1-ы завулак 	Островского 1-й переулок 	завулак
Астроўскага 2-і завулак 	Островского 2-й переулок 	завулак
Астроўскага 3-і завулак 	Островского 3-й переулок 	завулак
Бальнічны завулак 	Больничный переулок 	завулак
Барысаўская вуліца 	Борисовская улица 	вуліца
Барысаўскі завулак 	Борисовский переулок 	завулак
Батарэйная вуліца 	Батарейная улица 	вуліца
Батарэйны завулак 	Батарейный переулок 	завулак
Батурына вуліца 	Батурина улица 	вуліца
Батурына завулак 	Батурина переулок 	завулак
Бельскага вуліца 	Бельского улица 	вуліца
Берагавая вуліца 	Береговая улица 	вуліца
Берагавы завулак 	Береговой переулок 	завулак
Бетонная вуліца 	Бетонная улица 	вуліца
Блюхера вуліца 	Блюхера улица 	вуліца
Братоў Вайнрубаў вуліца 	Братьев Вайнрубов улица 	вуліца
Брылёўская вуліца 	Брилёвская улица 	вуліца
Будаўнікоў вуліца 	Строителей улица 	вуліца
Бялявіна вуліца 	Белявина улица 	вуліца
Бярэзінская вуліца 	Березинская улица 	вуліца
Бярэзінская шаша 	Березинское шоссе 	шаша
Бярэзінскі завулак 	Березинский переулок 	завулак
Вакзальная вуліца 	Вокзальная улица 	вуліца
Ватуціна вуліца 	Ватутина улица 	вуліца
Віцебская вуліца 	Витебская улица 	вуліца
Вызвалення завулак 	Освобождения переулок 	завулак
Вясёлкавая вуліца 	Радужная улица 	вуліца
Вясёлкавы 1-ы завулак 	Радужный 1-й переулок 	завулак
Вясёлкавы 2-і завулак 	Радужный 2-й переулок 	завулак
Вясёлкавы 3-і завулак 	Радужный 3-й переулок 	завулак
Газетная вуліца 	Газетная улица 	вуліца
Газетны завулак 	Газетный переулок 	завулак
Галіцкага вуліца 	Галицкого улица 	вуліца
Ганчарная вуліца 	Гончарная улица 	вуліца
Гаранская вуліца 	Горанская улица 	вуліца
Гаранскі 1-ы завулак 	Горанский 1-й переулок 	завулак
Гаранскі 2-і завулак 	Горанский 2-й переулок 	завулак
Гастэлы вуліца 	Гастелло улица 	вуліца
Гвардзейская вуліца 	Гвардейская улица 	вуліца
Гвардзейскі завулак 	Гвардейский переулок 	завулак
Герцэна вуліца 	Герцена улица 	вуліца
Гогаля вуліца 	Гоголя улица 	вуліца
Гомельская вуліца 	Гомельская улица 	вуліца
Гомельскі завулак 	Гомельский переулок 	завулак
Горны завулак 	Горный переулок 	завулак
Грэчкі бульвар 	Гречко бульвар 	бульвар
Даватара вуліца 	Доватора улица 	вуліца
Далёкі завулак 	Дальний переулок 	завулак
Данілава вуліца 	Данилова улица 	вуліца
Даўмана вуліца 	Даумана улица 	вуліца
Дачная вуліца 	Дачная улица 	вуліца
Дачны завулак 	Дачный переулок 	завулак
Дзекабрыстаў вуліца 	Декабристов улица 	вуліца
Дзёміна вуліца 	Дёмина улица 	вуліца
Дзяржынскага вуліца 	Дзержинского улица 	вуліца
Дняпроўская вуліца 	Днепровская улица 	вуліца
Дымкі вуліца 	Дымки улица 	вуліца
Дымкі завулак 	Дымки переулок 	завулак
Жуковіча вуліца 	Жуковича улица 	вуліца
Жылуновіча вуліца 	Жилуновича улица 	вуліца
Заводская вуліца 	Заводская улица 	вуліца
Загарадная вуліца 	Загородная улица 	вуліца
Загарадны завулак 	Загородный переулок 	завулак
Залинейная вуліца 	Залинейная улица 	вуліца
Залінейны 1-ы завулак 	Залинейный 1-й переулок 	завулак
Залінейны 2-і завулак 	Залинейный 2-й переулок 	завулак
Залінейны 3-і завулак 	Залинейный 3-й переулок 	завулак
Залінейны 4-ы завулак 	Залинейный 4-й переулок 	завулак
Залінейны 5-ы завулак 	Залинейный 5-й переулок 	завулак
Залінейны 6-ы завулак 	Залинейный 6-й переулок 	завулак
Залінейны 7-ы завулак 	Залинейный 7-й переулок 	завулак
Залінейны 8-ы завулак 	Залинейный 8-й переулок 	завулак
Залінейны 9-ы завулак 	Залинейный 9-й переулок 	завулак
Зарэчная вуліца 	Заречная улица 	вуліца
Зарэчны 1-ы завулак 	Заречный 1-й переулок 	завулак
Зарэчны 2-і завулак 	Заречный 2-й переулок 	завулак
Зарэчны 3-і завулак 	Заречный 3-й переулок 	завулак
Зарэчны 4-ы завулак 	Заречный 4-й переулок 	завулак
Заходні завулак 	Западный переулок 	завулак
Заходняя вуліца 	Западная улица 	вуліца
Зоі Касмадзям’янскай вуліца 	Зои Космодемьянской улица 	вуліца
Зялёны Гарадок вуліца 	Зелёный Городок улица 	вуліца
Зялёны завулак 	Зелёный переулок 	завулак
Ібаруры вуліца 	Ибаррури улица 	вуліца
Індустрыяльная вуліца 	Индустриальная улица 	вуліца
Індустрыяльны 1-ы завулак 	Индустриальный 1-й переулок 	завулак
Індустрыяльны 2-і завулак 	Индустриальный 2-й переулок 	завулак
Індустрыяльны 3-і завулак 	Индустриальный 3-й переулок 	завулак
Інкубатарная вуліца 	Инкубаторная улица 	вуліца
Інкубатарны завулак 	Инкубаторный переулок 	завулак
Кавалерыйская вуліца 	Кавалерийская улица 	вуліца
Кавалерыйскі 1-ы завулак 	Кавалерийский 1-й переулок 	завулак
Кавалерыйскі 2-і завулак 	Кавалерийский 2-й переулок 	завулак
Кавалерыйскі 3-і завулак 	Кавалерийский 3-й переулок 	завулак
Кавалерыйскі 4-ы завулак 	Кавалерийский 4-й переулок 	завулак
Кавалерыйскі 5-ы завулак 	Кавалерийский 5-й переулок 	завулак
Кавалеўскага вуліца 	Ковалевского улица 	вуліца
Кавальская вуліца 	Кузнечная улица 	вуліца
Калектыўная вуліца 	Коллективная улица 	вуліца
Каляровая вуліца 	Цветная улица 	вуліца
Каляровы завулак 	Цветной переулок 	завулак
Камарова бульвар 	Комарова бульвар 	бульвар
Камінскага вуліца 	Каминского улица 	вуліца
Камінтэрна вуліца 	Коминтерна улица 	вуліца
Камінтэрна завулак 	Коминтерна переулок 	завулак
Камсамольская вуліца 	Комсомольская улица 	вуліца
Камсамольскі завулак 	Комсомольский переулок 	завулак
Камунальная вуліца 	Коммунальная улица 	вуліца
Камунарная вуліца 	Коммунарная улица 	вуліца
Канстанціна Заслонава вуліца 	Константина Заслонова улица 	вуліца
Карла Лібкнехта вуліца 	Карла Либкнехта улица 	вуліца
Карла Лібкнехта завулак 	Карла Либкнехта переулок 	завулак
Карла Лібкнехта 1-ы завулак 	Карла Либкнехта 1-й переулок 	завулак
Карла Лібкнехта 2-і завулак 	Карла Либкнехта 2-й переулок 	завулак
Карла Лібкнехта 3-і завулак 	Карла Либкнехта 3-й переулок 	завулак
Карла Лібкнехта 4-ы завулак 	Карла Либкнехта 4-й переулок 	завулак
Карла Лібкнехта 5-ы завулак 	Карла Либкнехта 5-й переулок 	завулак
Карла Маркса вуліца 	Карла Маркса улица 	вуліца
Кастрычніцкая вуліца 	Октябрьская улица 	вуліца
Кастрычніцкі завулак 	Октябрьский переулок 	завулак
Касцюшкі вуліца 	Костюшко улица 	вуліца
Катоўскага вуліца 	Котовского улица 	вуліца
Кіеўская вуліца 	Киевская улица 	вуліца
Кіеўскі завулак 	Киевский переулок 	завулак
Кутузава вуліца 	Кутузова улица 	вуліца
Лагерны завулак 	Лагерный переулок 	завулак
Лагерны 2-і завулак 	Лагерный 2-й переулок 	завулак
Лагойская вуліца 	Логойская улица 	вуліца
Лазневы завулак 	Банный переулок 	завулак
Лапаціна вуліца 	Лопатина улица 	вуліца
Ленінградская вуліца 	Ленинградская улица 	вуліца
Ленінская вуліца 	Ленинская улица 	вуліца
Лепельскі завулак 	Лепельский переулок 	завулак
Лепельскі 2-і завулак 	Лепельский 2-й переулок 	завулак
Лермантава вуліца 	Лермонтова улица 	вуліца
Лермантава 1-ы завулак 	Лермонтова 1-й переулок 	завулак
Лермантава 2-і завулак 	Лермонтова 2-й переулок 	завулак
Лесахімічная вуліца 	Лесохимическая улица 	вуліца
Лугавая вуліца 	Луговая улица 	вуліца
Лугавы завулак 	Луговой переулок 	завулак
Лугавы 2-і завулак 	Луговой 2-й переулок 	завулак
Люсі Чалоўскай вуліца 	Люси Чаловской улица 	вуліца
Лясная вуліца 	Лесная улица 	вуліца
Лясны завулак 	Лесной переулок 	завулак
Магнітагорская вуліца 	Магнитогорская улица 	вуліца
Магнітагорскі завулак 	Магнитогорский переулок 	завулак
Максіма Горкага вуліца 	Максима Горького улица 	вуліца
Маладзёжная вуліца 	Молодёжная улица 	вуліца
Маладзёжны 1-ы завулак 	Молодёжный 1-й переулок 	завулак
Маладзёжны 2-і завулак 	Молодёжный 2-й переулок 	завулак
Маладзёжны 3-і завулак 	Молодёжный 3-й переулок 	завулак
Малая вуліца 	Малая улица 	вуліца
Маскоўскі завулак 	Московский переулок 	завулак
Маставы завулак 	Мостовой переулок 	завулак
Матросава вуліца 	Матросова улица 	вуліца
Матросава завулак 	Матросова переулок 	завулак
Меліярацыйная вуліца 	Мелиоративная улица 	вуліца
Мінская вуліца 	Минская улица 	вуліца
Мінскі завулак 	Минский переулок 	завулак
Мірная вуліца 	Мирная улица 	вуліца
Міхаіла Марозава вуліца 	Михаила Морозова улица 	вуліца
Мічурына вуліца 	Мичурина улица 	вуліца
Мічурына завулак 	Мичурина переулок 	завулак
Млынавы завулак 	Мельничный переулок 	завулак
Мопраўская вуліца 	Мопровская улица 	вуліца
Мопраўскі завулак 	Мопровский переулок 	завулак
Мохавы завулак 	Моховой переулок 	завулак
Мэблевы завулак 	Мебельный переулок 	завулак
Набярэжная вуліца 	Набережная улица 	вуліца
Наватараў вуліца 	Новаторов улица 	вуліца
Нахіленая вуліца 	Наклонная улица 	вуліца
Новая вуліца 	Новая улица 	вуліца
Новы завулак 	Новый переулок 	завулак
Някрасава завулак 	Некрасова переулок 	завулак
Пагранічная вуліца 	Пограничная улица 	вуліца
Пагранічны 1-ы завулак 	Пограничный 1-й переулок 	завулак
Пагранічны 2-і завулак 	Пограничный 2-й переулок 	завулак
Падлесная вуліца 	Подлесная улица 	вуліца
Падлесны 1-ы завулак 	Подлесный 1-й переулок 	завулак
Падлесны 2-і завулак 	Подлесный 2-й переулок 	завулак
Падлесны 3-і завулак 	Подлесный 3-й переулок 	завулак
Падлесны 4-ы завулак 	Подлесный 4-й переулок 	завулак
Падлесны 5-ы завулак 	Подлесный 5-й переулок 	завулак
Палескі завулак 	Полесский переулок 	завулак
Палка Нармандыя-Нёман вуліца 	Полка Нормандия-Неман улица 	вуліца
Палявая вуліца 	Полевая улица 	вуліца
Палявы завулак 	Полевой переулок 	завулак
Палярная вуліца 	Полярная улица 	вуліца
Панфілава вуліца 	Панфилова улица 	вуліца
Панфілава 1-ы завулак 	Панфилова 1-й переулок 	завулак
Панфілава 2-і завулак 	Панфилова 2-й переулок 	завулак
Панфілава 3-і завулак 	Панфилова 3-й переулок 	завулак
Папаніна вуліца 	Папанина улица 	вуліца
Папаніна завулак 	Папанина переулок 	завулак
Папова 1-ы завулак 	Попова 1-й переулок 	завулак
Папова 2-і завулак 	Попова 2-й переулок 	завулак
Папяровая вуліца 	Бумажная улица 	вуліца
Папяровы завулак 	Бумажный переулок 	завулак
Паралельная вуліца 	Параллельная улица 	вуліца
Парашутыстаў вуліца 	Парашютистов улица 	вуліца
Парашутыстаў завулак 	Парашютистов переулок 	завулак
Паркавая вуліца 	Парковая улица 	вуліца
Партызанская вуліца 	Партизанская улица 	вуліца
Паўднёва-Ўсходні 1-ы завулак 	Юго-Восточный 1-й переулок 	завулак
Паўднёва-Ўсходні 2-і завулак 	Юго-Восточный 2-й переулок 	завулак
Паўднёва-Ўсходні 3-і завулак 	Юго-Восточный 3-й переулок 	завулак
Паўднёва-Ўсходні 4-ы завулак 	Юго-Восточный 4-й переулок 	завулак
Паўднёва-Ўсходняя вуліца 	Юго-Восточная улица 	вуліца
Паўднёвая вуліца 	Южная улица 	вуліца
Паўднёвы завулак 	Южный переулок 	завулак
Паўла Рака вуліца 	Павла Рака улица 	вуліца
Паўлава вуліца 	Павлова улица 	вуліца
Паўлава завулак 	Павлова переулок 	завулак
Паўночная вуліца 	Северная улица 	вуліца
Паўночны завулак 	Северный переулок 	завулак
Паштовая вуліца 	Почтовая улица 	вуліца
Паштовы завулак 	Почтовый переулок 	завулак
Пілотаў завулак 	Пилотов переулок 	завулак
Пірагова вуліца 	Пирогова улица 	вуліца
Пірагова 1-ы завулак 	Пирогова 1-й переулок 	завулак
Пірагова 2-і завулак 	Пирогова 2-й переулок 	завулак
Пірагова 3-і завулак 	Пирогова 3-й переулок 	завулак
Піянерскі завулак 	Пионерский переулок 	завулак
Планёрная вуліца 	Планёрная улица 	вуліца
Планёрны завулак 	Планёрный переулок 	завулак
Правабярэжная вуліца 	Правобережная улица 	вуліца
Пралетарская вуліца 	Пролетарская улица 	вуліца
Прафінтэрна вуліца 	Профинтерна улица 	вуліца
Прафінтэрна 1-ы завулак 	Профинтерна 1-й переулок 	завулак
Прафінтэрна 2-і завулак 	Профинтерна 2-й переулок 	завулак
Працоўная вуліца 	Трудовая улица 	вуліца
Працы вуліца 	Труда улица 	вуліца
Працы завулак 	Труда переулок 	завулак
Прыгарадная вуліца 	Пригородная улица 	вуліца
Прышвіна вуліца 	Пришвина улица 	вуліца
Прышвіна 1-ы завулак 	Пришвина 1-й переулок 	завулак
Прышвіна 2-і завулак 	Пришвина 2-й переулок 	завулак
Прышвіна 3-і завулак 	Пришвина 3-й переулок 	завулак
Пугачова вуліца 	Пугачёва улица 	вуліца
Пугачова завулак 	Пугачёва переулок 	завулак
Пуліхава вуліца 	Пулихова улица 	вуліца
Пуцейная вуліца 	Путейная улица 	вуліца
Пушкіна вуліца 	Пушкина улица 	вуліца
Пушкіна завулак 	Пушкина переулок 	завулак
Пыжыкава вуліца 	Пыжикова улица 	вуліца
Пясчаная вуліца 	Песчаная улица 	вуліца
Пятраева вуліца 	Петряева улица 	вуліца
Пятраева завулак 	Петряева переулок 	завулак
Рабочая вуліца 	Рабочая улица 	вуліца
Рабочы завулак 	Рабочий переулок 	завулак
Рабочы Хімік вуліца 	Рабочий Химик улица 	вуліца
Рачны завулак 	Речной переулок 	завулак
Розы Люксембург вуліца 	Розы Люксембург улица 	вуліца
Розы Люксембург завулак 	Розы Люксембург переулок 	завулак
Рэвалюцыі праспект 	Революции проспект 	праспект
Рэспубліканская вуліца 	Республиканская улица 	вуліца
Савецкая вуліца 	Советская улица 	вуліца
Савецкі завулак 	Советский переулок 	завулак
Садовы завулак 	Садовый переулок 	завулак
Сапёрны завулак 	Сапёрный переулок 	завулак
Сасновая вуліца 	Сосновая улица 	вуліца
Сацыялістычная вуліца 	Социалистическая улица 	вуліца
Сацыялістычны завулак 	Социалистический переулок 	завулак
Свабоды завулак 	Свободы переулок 	завулак
Святлова вуліца 	Светлова улица 	вуліца
Смаленская вуліца 	Смоленская улица 	вуліца
Смалявіцкая вуліца 	Смолевичская улица 	вуліца
Смірнова вуліца 	Смирнова улица 	вуліца
Сонечны 1-й завулак 	Солнечный 1-й переулок 	завулак
Сонечны 2-і завулак 	Солнечный 2-й переулок 	завулак
Сонечны 3-і завулак 	Солнечный 3-й переулок 	завулак
Сонечны 4-ы завулак 	Солнечный 4-й переулок 	завулак
Спартыўны завулак 	Спортивный переулок 	завулак
Спартыўны праезд 	Спортивный проезд 	праезд
Стаханаўская вуліца 	Стахановская улица 	вуліца
Стралковы завулак 	Стрелковый переулок 	завулак
Студэнцкі завулак 	Студенческий переулок 	завулак
Суворава вуліца 	Суворова улица 	вуліца
Суворава завулак 	Суворова переулок 	завулак
Сувязная вуліца 	Связная улица 	вуліца
Супруна вуліца 	Супруна улица 	вуліца
Сцяпана Разіна вуліца 	Степана Разина улица 	вуліца
Сцяпана Разіна завулак 	Степана Разина переулок 	завулак
Сянная вуліца 	Сенная улица 	вуліца
Сянны завулак 	Сенной переулок 	завулак
Сяргея Лазо вуліца 	Сергея Лазо улица 	вуліца
Сяргея Лазо завулак 	Сергея Лазо переулок 	завулак
Сярэбранікава вуліца 	Серебренникова улица 	вуліца
Талстога вуліца 	Толстого улица 	вуліца
Танкавы завулак 	Танковый переулок 	завулак
Тараса Шаўчэнкі вуліца 	Тараса Шевченко улица 	вуліца
Тарфяная вуліца 	Торфяная улица 	вуліца
Тарфяны завулак 	Торфяной переулок 	завулак
Толсцікава вуліца 	Толстикова улица 	вуліца
Транспартная вуліца 	Транспортная улица 	вуліца
Трусава вуліца 	Трусова улица 	вуліца
Тургенева вуліца 	Тургенева улица 	вуліца
Тургенева завулак 	Тургенева переулок 	завулак
Тургенева 2-і завулак 	Тургенева 2-й переулок 	завулак
Тургенева 3-і завулак 	Тургенева 3-й переулок 	завулак
Тухачэўскага вуліца 	Тухачевского улица 	вуліца
Урыцкага вуліца 	Урицкого улица 	вуліца
Усходняя вуліца 	Восточная улица 	вуліца
Фабрыцыуса вуліца 	Фабрициуса улица 	вуліца
Фабрыцыуса 1-ы завулак 	Фабрициуса 1-й переулок 	завулак
Фабрыцыуса 2-і завулак 	Фабрициуса 2-й переулок 	завулак
Фабрыцыуса 3-і завулак 	Фабрициуса 3-й переулок 	завулак
Фабрыцыуса 4-ы завулак 	Фабрициуса 4-й переулок 	завулак
Фанерная вуліца 	Фанерная улица 	вуліца
Фанерны завулак 	Фанерный переулок 	завулак
Фрунзэ вуліца 	Фрунзе улица 	вуліца
Фрунзэ 1-ы завулак 	Фрунзе 1-й переулок 	завулак
Фрунзэ 2-і завулак 	Фрунзе 2-й переулок 	завулак
Хацкевіча вуліца 	Хацкевича улица 	вуліца
Ціміразева вуліца 	Тимирязева улица 	вуліца
Ціміразева 1-ы завулак 	Тимирязева 1-й переулок 	завулак
Ціміразева 2-і завулак 	Тимирязева 2-й переулок 	завулак
Ціхі завулак 	Тихий переулок 	завулак
Цэнтральная плошча 	Центральная площадь 	плошча
Чапаева вуліца 	Чапаева улица 	вуліца
Чарняхоўскага вуліца 	Черняховского улица 	вуліца
Чарняхоўскага завулак 	Черняховского переулок 	завулак
Чкалава вуліца 	Чкалова улица 	вуліца
Чкалава 1-ы завулак 	Чкалова 1-й переулок 	завулак
Чкалава 2-і завулак 	Чкалова 2-й переулок 	завулак
Чкалава 3-і завулак 	Чкалова 3-й переулок 	завулак
Чкалава 4-ы завулак 	Чкалова 4-й переулок 	завулак
Чкалава 5-ы завулак 	Чкалова 5-й переулок 	завулак
Чкалава 6-ы завулак 	Чкалова 6-й переулок 	завулак
Чкалава 7-ы завулак 	Чкалова 7-й переулок 	завулак
Чкалава 8-ы завулак 	Чкалова 8-й переулок 	завулак
Чырванасцяжная вуліца 	Краснознамённая улица 	вуліца
Чырванасцяжны завулак 	Краснознамённый переулок 	завулак
Чырвонаармейская вуліца 	Красноармейская улица 	вуліца
Чырвонаармейскі завулак 	Красноармейский переулок 	завулак
Чырвонаслабадскі завулак 	Краснослободской переулок 	завулак
Чырвоная вуліца 	Красная улица 	вуліца
Чырвоны завулак 	Красный переулок 	завулак
Чэхава вуліца 	Чехова улица 	вуліца
Шашэйная вуліца 	Шоссейная улица 	вуліца
Шкляная вуліца 	Стекольная улица 	вуліца
Школьная вуліца 	Школьная улица 	вуліца
Шміта вуліца 	Шмидта улица 	вуліца
Шміта завулак 	Шмидта переулок 	завулак
Шпітальная вуліца 	Госпитальная улица 	вуліца
Шчорса вуліца 	Щорса улица 	вуліца
Энгельса вуліца 	Энгельса улица 	вуліца
Энгельса завулак 	Энгельса переулок 	завулак
Юбілейная вуліца 	Юбилейная улица 	вуліца
Юрыя Гагарына вуліца 	Юрия Гагарина улица 	вуліца
Юшкевіцкая вуліца 	Юшкевичская улица 	вуліца
Юшкевіцкі 1-ы завулак 	Юшкевичский 1-й переулок 	завулак
Юшкевіцкі 2-і завулак 	Юшкевичский 2-й переулок 	завулак
Юшкевіцкі 3-і завулак 	Юшкевичский 3-й переулок 	завулак
Юшкевіцкі 4-ы завулак 	Юшкевичский 4-й переулок 	завулак
Юшкевіцкі 5-ы завулак 	Юшкевичский 5-й переулок 	завулак
Якуба Коласа вуліца 	Якуба Коласа улица 	вуліца
Янкі Купалы вуліца 	Янки Купалы улица 	вуліца
Яраша вуліца 	Яроша улица 	вуліца
Ясная вуліца 	Ясная улица 	вуліца