1 Мая завулак 	1 Мая переулок 	завулак
9 Студзеня вуліца 	9 Января улица 	вуліца
17 верасня вуліца 	17 сентября улица 	вуліца
28 ліпеня вуліца 	28 июля улица 	вуліца
Абаронцаў Айчыны вуліца 	Защитников Отечества улица 	вуліца
Абрыкосавая вуліца 	Абрикосовая улица 	вуліца
Абходная вуліца 	Обходная улица 	вуліца
Авіяцыйны завулак 	Авиационный переулок 	завулак
Агародная вуліца 	Огородная улица 	вуліца
Адамкоўская вуліца 	Адамковская улица 	вуліца
Адраджэння вуліца 	Возрождения улица 	вуліца
Азёрная вуліца 	Озёрная улица 	вуліца
Азёрны завулак 	Озёрный переулок 	завулак
Азярцовая вуліца 	Озерцовая улица 	вуліца
Азярцовы завулак 	Озерцовый переулок 	завулак
Аксамітная вуліца 	Бархатная улица 	вуліца
Алега Кашавога вуліца 	Олега Кошевого улица 	вуліца
Альховая вуліца 	Ольховая улица 	вуліца
Альшанская вуліца 	Ольшанская улица 	вуліца
Аляксандраўская вуліца 	Александровская улица 	вуліца
Арджанікідзэ вуліца 	Орджоникидзе улица 	вуліца
Аржаная вуліца 	Ржаная улица 	вуліца
Аржаны 1-ы завулак 	Ржаной 1-й переулок 	завулак
Аржаны 2-і завулак 	Ржаной 2-й переулок 	завулак
Аркадзьеўская вуліца 	Аркадьевская улица 	вуліца
Арлоўская вуліца 	Орловская улица 	вуліца
Армейская вуліца 	Армейская улица 	вуліца
Аршанская вуліца 	Оршанская улица 	вуліца
Арэхавая вуліца 	Ореховая улица 	вуліца
Арэхавы завулак 	Ореховый переулок 	завулак
Асенняя вуліца 	Осенняя улица 	вуліца
Асіпенкі вуліца 	Осипенко улица 	вуліца
Астрамечаўская вуліца 	Остромечевская улица 	вуліца
Астрамечаўскі 1-ы завулак 	Остромечевский 1-й переулок 	завулак
Астрамечаўскі 2-і завулак 	Остромечевский 2-й переулок 	завулак
Астроўскага вуліца 	Островского улица 	вуліца
Аўгустоўская вуліца 	Августовская улица 	вуліца
Аўтааматараў вуліца 	Автолюбителей улица 	вуліца
Аўтамабілістаў вуліца 	Автомобилистов улица 	вуліца
Аэрадромная вуліца 	Аэродромная улица 	вуліца
Баброва вуліца 	Боброва улица 	вуліца
Багданчука вуліца 	Богданчука улица 	вуліца
Базанавай вуліца 	Базановой улица 	вуліца
Баравая вуліца 	Боровая улица 	вуліца
Баравы 1-ы завулак 	Боровой 1-й переулок 	завулак
Баравы 2-і завулак 	Боровой 2-й переулок 	завулак
Барадзінская вуліца 	Бородинская улица 	вуліца
Барсукова вуліца 	Барсукова улица 	вуліца
Барыкадная вуліца 	Баррикадная улица 	вуліца
Барысаўская вуліца 	Борисовская улица 	вуліца
Батанічная вуліца 	Ботаническая улица 	вуліца
Баўманская вуліца 	Бауманская улица 	вуліца
Бегавая вуліца 	Беговая улица 	вуліца
Белаазёрская вуліца 	Белоозёрская улица 	вуліца
Белавежская вуліца 	Беловежская улица 	вуліца
Беларуская вуліца 	Белорусская улица 	вуліца
Беларуская 1-я вуліца 	Белорусская 1-я улица 	вуліца
Беларуская 2-я вуліца 	Белорусская 2-я улица 	вуліца
Беларускі завулак 	Белорусский переулок 	завулак
Берагавая вуліца 	Береговая улица 	вуліца
Бераставая вуліца 	Берестовая улица 	вуліца
Берасцейская вуліца 	Берестейская улица 	вуліца
Берасцейская шаша 	Берестейское шоссе 	шаша
Бехцерава вуліца 	Бехтерева улица 	вуліца
Бехцерава 1-ы завулак 	Бехтерева 1-й переулок 	завулак
Бехцерава 2-і завулак 	Бехтерева 2-й переулок 	завулак
Бехцерава 3-і завулак 	Бехтерева 3-й переулок 	завулак
Бехцерава праезд 	Бехтерева проезд 	праезд
Благавешчанская вуліца 	Благовещенская улица 	вуліца
Блакітная вуліца 	Голубая улица 	вуліца
Блакітная вуліца 	Лазурная улица 	вуліца
Брацкая вуліца 	Братская улица 	вуліца
Бруснічная вуліца 	Брусничная улица 	вуліца
Бруснічны завулак 	Брусничный переулок 	завулак
Брэсцкі завулак 	Брестский переулок 	завулак
Брэсцкіх дывізій вуліца 	Брестских дивизий улица 	вуліца
Брэсцкіх дывізій завулак 	Брестских дивизий переулок 	завулак
Будаўнічая вуліца 	Строительная улица 	вуліца
Будзённага вуліца 	Будённого улица 	вуліца
Бульварная вуліца 	Бульварная улица 	вуліца
Бульварны завулак 	Бульварный переулок 	завулак
Бытко вуліца 	Бытко улица 	вуліца
Бэзавая вуліца 	Сиреневая улица 	вуліца
Бялінскага вуліца 	Белинского улица 	вуліца
Бялова вуліца 	Белова улица 	вуліца
Бярнадская вуліца 	Бернадская улица 	вуліца
Бярозавая вуліца 	Берёзовая улица 	вуліца
Бярозаўская вуліца 	Берёзовская улица 	вуліца
Бярозаўскі завулак 	Берёзовский переулок 	завулак
Бярозаўскі праезд 	Берёзовский проезд 	праезд
Бярэзінская вуліца 	Березинская улица 	вуліца
Валадарскага вуліца 	Володарского улица 	вуліца
Валгаградская вуліца 	Волгоградская улица 	вуліца
Валынская вуліца 	Волынская улица 	вуліца
Вараб’ёва вуліца 	Воробьёва улица 	вуліца
Вараб’ёва завулак 	Воробьёва переулок 	завулак
Варонья вуліца 	Воронья улица 	вуліца
Вароўскага вуліца 	Воровского улица 	вуліца
Варшаўская шаша 	Варшавское шоссе 	шаша
Васільеўская вуліца 	Васильевская улица 	вуліца
Васільеўскі завулак 	Васильевский переулок 	завулак
Васільковая вуліца 	Васильковая улица 	вуліца
Васняцова вуліца 	Васнецова улица 	вуліца
Верасовая вуліца 	Вересковая улица 	вуліца
Верасовая 1-я вуліца 	Вересковая 1-я улица 	вуліца
Верасовая 2-я вуліца 	Вересковая 2-я улица 	вуліца
Верасовая 3-я вуліца 	Вересковая 3-я улица 	вуліца
Верасовая 4-я вуліца 	Вересковая 4-я улица 	вуліца
Верасовая 5-я вуліца 	Вересковая 5-я улица 	вуліца
Верасовая 6-я вуліца 	Вересковая 6-я улица 	вуліца
Верасовая 7-я вуліца 	Вересковая 7-я улица 	вуліца
Верасовая 8-я вуліца 	Вересковая 8-я улица 	вуліца
Верасовая 9-я вуліца 	Вересковая 9-я улица 	вуліца
Верасовая 10-я вуліца 	Вересковая 10-я улица 	вуліца
Верасовы 1-ы завулак 	Вересковый 1-й переулок 	завулак
Верашчагіна вуліца 	Верещагина улица 	вуліца
Вербная вуліца 	Вербная улица 	вуліца
Веры Харужай вуліца 	Веры Хоружей улица 	вуліца
Віленская вуліца 	Виленская улица 	вуліца
Віленскі завулак 	Виленский переулок 	завулак
Віленскі 1-ы завулак 	Виленский 1-й переулок 	завулак
Віленскі 2-і завулак 	Виленский 2-й переулок 	завулак
Віленскі 3-і завулак 	Виленский 3-й переулок 	завулак
Вінаградная вуліца 	Виноградная улица 	вуліца
Вінніка вуліца 	Винника улица 	вуліца
Вінніка завулак 	Винника переулок 	завулак
Вішнёвая вуліца 	Вишнёвая улица 	вуліца
Вішнёвая 2-я вуліца 	Вишнёвая 2-я улица 	вуліца
Вішнёвы завулак 	Вишнёвый переулок 	завулак
Вішнёвы 1-ы завулак 	Вишнёвый 1-й переулок 	завулак
Воінаў-інтэрнацыяналістаў вуліца 	Воинов-интернационалистов улица 	вуліца
Войкава вуліца 	Войкова улица 	вуліца
Вольная вуліца 	Вольная улица 	вуліца
Вуглавая вуліца 	Угловая улица 	вуліца
Вузаўская вуліца 	Вузовская улица 	вуліца
Вузаўскі завулак 	Вузовский переулок 	завулак
Вузкая вуліца 	Узкая улица 	вуліца
Вулькаўская вуліца 	Вульковская улица 	вуліца
Высокаўская вуліца 	Высоковская улица 	вуліца
Высокая вуліца 	Высокая улица 	вуліца
Высокі завулак 	Высокий переулок 	завулак
Вычулкі вуліца 	Вычулки улица 	вуліца
Вярбовая вуліца 	Вербовая улица 	вуліца
Вясенні завулак 	Весенний переулок 	завулак
Вясенняя вуліца 	Весенняя улица 	вуліца
Вясёлая вуліца 	Весёлая улица 	вуліца
Вясёлы завулак 	Весёлый переулок 	завулак
Вясёлы 1-ы завулак 	Весёлый 1-й переулок 	завулак
Вячэрні завулак 	Вечерний переулок 	завулак
Гагарына вуліца 	Гагарина улица 	вуліца
Гагарына завулак 	Гагарина переулок 	завулак
Гаёвая вуліца 	Рощинская улица 	вуліца
Газдзецкага вуліца 	Гоздецкого улица 	вуліца
Галіны Аржанавай вуліца 	Галины Аржановой улица 	вуліца
Галіны Аржанавай завулак 	Галины Аржановой переулок 	завулак
Галубіная вуліца 	Голубиная улица 	вуліца
Гараднянская вуліца 	Городнянская улица 	вуліца
Гарадская вуліца 	Городская улица 	вуліца
Гарадскі завулак 	Городской переулок 	завулак
Гастэлы вуліца 	Гастелло улица 	вуліца
Гаўрылава вуліца 	Гаврилова улица 	вуліца
Гвардзейская вуліца 	Гвардейская улица 	вуліца
Генерала Благавешчанскага вуліца 	Генерала Благовещенского улица 	вуліца
Генерала Папова вуліца 	Генерала Попова улица 	вуліца
Генерала Цімафеева вуліца 	Генерала Тимофеева улица 	вуліца
Георгіеўская вуліца 	Георгиевская улица 	вуліца
Герояў абароны Брэсцкай крэпасці вуліца 	Героев обороны Брестской крепости улица 	вуліца
Герцэна вуліца 	Герцена улица 	вуліца
Герцэна завулак 	Герцена переулок 	завулак
Гершонская вуліца 	Гершонская улица 	вуліца
Глінкі вуліца 	Глинки улица 	вуліца
Глінная вуліца 	Глинная улица 	вуліца
Гогаля вуліца 	Гоголя улица 	вуліца
Горкага вуліца 	Горького улица 	вуліца
Гранічная вуліца 	Граничная улица 	вуліца
Гранічны завулак 	Граничный переулок 	завулак
Гродзенская вуліца 	Гродненская улица 	вуліца
Грунвальдская вуліца 	Грюнвальдская улица 	вуліца
Грушавая вуліца 	Грушевая улица 	вуліца
Грыбаедава вуліца 	Грибоедова улица 	вуліца
Грыбная вуліца 	Грибная улица 	вуліца
Грыцаўца вуліца 	Грицевца улица 	вуліца
Грыцаўца завулак 	Грицевца переулок 	завулак
Гурава вуліца 	Гурова улица 	вуліца
Дабралюбава завулак 	Добролюбова переулок 	завулак
Дазорная вуліца 	Дозорная улица 	вуліца
Далёкая вуліца 	Далёкая улица 	вуліца
Далёкі завулак 	Далёкий переулок 	завулак
Дальняя вуліца 	Дальняя улица 	вуліца
Дарвіна вуліца 	Дарвина улица 	вуліца
Дачная вуліца 	Дачная улица 	вуліца
Дачны праезд вуліца 	Дачный проезд улица 	вуліца
Дварцовая вуліца 	Дворцовая улица 	вуліца
Дворнікава вуліца 	Дворникова улица 	вуліца
Дворчык вуліца 	Дворчик улица 	вуліца
Дзекабрыстаў вуліца 	Декабристов улица 	вуліца
Дзмітрыя Данскога вуліца 	Дмитрия Донского улица 	вуліца
Дзмітрыя Данскога завулак 	Дмитрия Донского переулок 	завулак
Дзяржынскага вуліца 	Дзержинского улица 	вуліца
Добрая вуліца 	Добрая улица 	вуліца
Добры завулак 	Добрый переулок 	завулак
Дружная вуліца 	Дружная улица 	вуліца
Дружны 1-ы завулак 	Дружный 1-й переулок 	завулак
Дружны 2-і завулак 	Дружный 2-й переулок 	завулак
Дружны 3-і завулак 	Дружный 3-й переулок 	завулак
Дружны 4-ы завулак 	Дружный 4-й переулок 	завулак
Дружны 5-ы завулак 	Дружный 5-й переулок 	завулак
Дуброўская вуліца 	Дубровская улица 	вуліца
Дуброўскі завулак 	Дубровский переулок 	завулак
Дывінская вуліца 	Дивинская улица 	вуліца
Дэпутацкі завулак 	Депутатский переулок 	завулак
Дэсантнікаў завулак 	Десантников переулок 	завулак
Екельчыка вуліца 	Екельчика улица 	вуліца
Жукава вуліца 	Жукова улица 	вуліца
Жукава завулак 	Жукова переулок 	завулак
Жукоўскага вуліца 	Жуковского улица 	вуліца
Жукоўскага завулак 	Жуковского переулок 	завулак
Журавецкая вуліца 	Журавецкая улица 	вуліца
Журавецкі завулак 	Журавецкий переулок 	завулак
Журавінавая вуліца 	Журавинная улица 	вуліца
Жураўліная вуліца 	Журавлиная улица 	вуліца
Жытні завулак 	Житний переулок 	завулак
Жытняя вуліца 	Житняя улица 	вуліца
Жытомірская вуліца 	Житомирская улица 	вуліца
Заводская вуліца 	Заводская улица 	вуліца
Заводская 2-я вуліца 	Заводская 2-я улица 	вуліца
Заводскі 1-ы завулак 	Заводской 1-й переулок 	завулак
Заводскі 2-і завулак 	Заводской 2-й переулок 	завулак
Заводскі 3-і завулак 	Заводской 3-й переулок 	завулак
Загароднева вуліца 	Загороднева улица 	вуліца
Задарожная вуліца 	Задорожная улица 	вуліца
Задворская вуліца 	Задворская улица 	вуліца
Запаветная вуліца 	Заветная улица 	вуліца
Запрудная вуліца 	Запрудная улица 	вуліца
Зарнічная вуліца 	Зарничная улица 	вуліца
Зарэчная вуліца 	Заречная улица 	вуліца
Зарэчны 1-ы завулак 	Заречный 1-й переулок 	завулак
Засіма вуліца 	Засима улица 	вуліца
Заслонава вуліца 	Заслонова улица 	вуліца
Заходні 1-ы завулак 	Западный 1-й переулок 	завулак
Заходні 2-і завулак 	Западный 2-й переулок 	завулак
Заходні 3-і завулак 	Западный 3-й переулок 	завулак
Заходні 4-ы завулак 	Западный 4-й переулок 	завулак
Заходні 1-ы тупік 	Западный 1-й тупик 	тупік
Заходні 2-і тупік 	Западный 2-й тупик 	тупік
Звонкая вуліца 	Звонкая улица 	вуліца
Землянічная вуліца 	Земляничная улица 	вуліца
Зерневая вуліца 	Зерновая улица 	вуліца
Зімняя вуліца 	Зимняя улица 	вуліца
Зорная вуліца 	Звёздная улица 	вуліца
Зубачова вуліца 	Зубачёва улица 	вуліца
Зялёная вуліца 	Зелёная улица 	вуліца
Зялёны завулак 	Зелёный переулок 	завулак
Зялёны 1-ы завулак 	Зелёный 1-й переулок 	завулак
Зялёны 2-і завулак 	Зелёный 2-й переулок 	завулак
Ізумрудная вуліца 	Изумрудная улица 	вуліца
Ільінская вуліца 	Ильинская улица 	вуліца
Інжынерная вуліца 	Инженерная улица 	вуліца
Інтэрнацыянальная вуліца 	Интернациональная улица 	вуліца
Ірынінская вуліца 	Ирининская улица 	вуліца
Кааператыўная вуліца 	Кооперативная улица 	вуліца
Казачная вуліца 	Сказочная улица 	вуліца
Казловіцкая вуліца 	Козловичская улица 	вуліца
Калгасная вуліца 	Колхозная улица 	вуліца
Калесніка вуліца 	Колесника улица 	вуліца
Калінавая вуліца 	Калиновая улица 	вуліца
Калінавы завулак 	Калиновый переулок 	завулак
Калінавы 1-ы завулак 	Калиновый 1-й переулок 	завулак
Калінавы 2-і завулак 	Калиновый 2-й переулок 	завулак
Калінавы 3-і завулак 	Калиновый 3-й переулок 	завулак
Калінавы 4-ы завулак 	Калиновый 4-й переулок 	завулак
Калінавы 5-ы завулак 	Калиновый 5-й переулок 	завулак
Калінавы 6-ы завулак 	Калиновый 6-й переулок 	завулак
Калінавы 7-ы завулак 	Калиновый 7-й переулок 	завулак
Калінавы 8-ы завулак 	Калиновый 8-й переулок 	завулак
Калінавы 9-ы завулак 	Калиновый 9-й переулок 	завулак
Калініна вуліца 	Калинина улица 	вуліца
Кальцавая вуліца 	Кольцевая улица 	вуліца
Калядная вуліца 	Рождественская улица 	вуліца
Калядны 2-і завулак 	Рождественский 2-й переулок 	завулак
Каляровая вуліца 	Цветная улица 	вуліца
Камарынская вуліца 	Комаринская улица 	вуліца
Камбінатаўская вуліца 	Комбинатовская улица 	вуліца
Камбінатаўскі 1-ы завулак 	Комбинатовский 1-й переулок 	завулак
Камбінатаўскі 2-і завулак 	Комбинатовский 2-й переулок 	завулак
Каменная вуліца 	Каменная улица 	вуліца
Камерцыйная вуліца 	Коммерческая улица 	вуліца
Камерцыйны 1-ы завулак 	Коммерческий 1-й переулок 	завулак
Камерцыйны 2-і завулак 	Коммерческий 2-й переулок 	завулак
Камерцыйны праезд 	Коммерцийный проезд 	праезд
Камсамольская вуліца 	Комсомольская улица 	вуліца
Камуністычная вуліца 	Коммунистическая улица 	вуліца
Камянецкая вуліца 	Каменецкая улица 	вуліца
Камянецкі завулак 	Каменецкий переулок 	завулак
Кар’ерная вуліца 	Карьерная улица 	вуліца
Караленкі вуліца 	Короленко улица 	вуліца
Карасёва вуліца 	Карасёва улица 	вуліца
Карбышава вуліца 	Карбышева улица 	вуліца
Карвата вуліца 	Карвата улица 	вуліца
Карла Лібкнехта вуліца 	Карла Либкнехта улица 	вуліца
Карла Маркса вуліца 	Карла Маркса улица 	вуліца
Кароткая вуліца 	Короткая улица 	вуліца
Кароткі завулак 	Короткий переулок 	завулак
Кароткі 1-ы завулак 	Короткий 1-й переулок 	завулак
Касая вуліца 	Косая улица 	вуліца
Касіцкага вуліца 	Косицкого улица 	вуліца
Касманаўтаў бульвар 	Космонавтов бульвар 	бульвар
Кастрычніцкай Рэвалюцыі вуліца 	Октябрьской Революции улица 	вуліца
Кастрычніцкая вуліца 	Октябрьская улица 	вуліца
Касцюшкі вуліца 	Костюшко улица 	вуліца
Касцюшкі завулак 	Костюшко переулок 	завулак
Катоўскага вуліца 	Котовского улица 	вуліца
Кацельня-Баярская вуліца 	Котельня-Боярская улица 	вуліца
Кацін Бор вуліца 	Катин Бор улица 	вуліца
Каштанавая вуліца 	Каштановая улица 	вуліца
Каштанавы завулак 	Каштановый переулок 	завулак
Кветкавая вуліца 	Цветочная улица 	вуліца
Кедравая вуліца 	Кедровая улица 	вуліца
Кедравая 1-я вуліца 	Кедровая 1-я улица 	вуліца
Кедравая 2-я вуліца 	Кедровая 2-я улица 	вуліца
Кедравая 3-я вуліца 	Кедровая 3-я улица 	вуліца
Кедравая 4-я вуліца 	Кедровая 4-я улица 	вуліца
Кедравая 5-я вуліца 	Кедровая 5-я улица 	вуліца
Кіеўская вуліца 	Киевская улица 	вуліца
Кіеўскі 1-ы завулак 	Киевский 1-й переулок 	завулак
Кіеўскі 2-і завулак 	Киевский 2-й переулок 	завулак
Кіжаватава вуліца 	Кижеватова улица 	вуліца
Кіпарысавая вуліца 	Кипарисовая улица 	вуліца
Кіпарысавы завулак 	Кипарисовый переулок 	завулак
Кірава вуліца 	Кирова улица 	вуліца
Клары Цэткін вуліца 	Клары Цеткин улица 	вуліца
Клейнікаўская вуліца 	Клейниковская улица 	вуліца
Клейнікаўскі 1-ы завулак 	Клейниковский 1-й переулок 	завулак
Клейнікаўскі 2-і завулак 	Клейниковский 2-й переулок 	завулак
Клейнікаўскі праезд 	Клейниковский проезд 	праезд
Ключавая вуліца 	Ключевая улица 	вуліца
Кляновая вуліца 	Кленовая улица 	вуліца
Кляновы завулак 	Кленовый переулок 	завулак
Кобрынская вуліца 	Кобринская улица 	вуліца
Кобрынскі завулак 	Кобринский переулок 	завулак
Ковельская вуліца 	Ковельская улица 	вуліца
Ковельская шаша 	Ковельское шоссе 	шаша
Коласаўская вуліца 	Колосовская улица 	вуліца
Крайняя вуліца 	Крайняя улица 	вуліца
Крапасны праезд 	Крепостной проезд 	праезд
Кругавая вуліца 	Круговая улица 	вуліца
Крупскай вуліца 	Крупской улица 	вуліца
Крушынская вуліца 	Крушинская улица 	вуліца
Крывашэіна вуліца 	Кривошеина улица 	вуліца
Крынічная вуліца 	Родниковая улица 	вуліца
Крынічная вуліца 	Криничная улица 	вуліца
Крыштафовіча вуліца 	Криштофовича улица 	вуліца
Куйбышава вуліца 	Куйбышева улица 	вуліца
Купалаўская вуліца 	Купаловская улица 	вуліца
Купалаўскі 1-ы завулак 	Купаловский 1-й переулок 	завулак
Купалаўскі 2-і завулак 	Купаловский 2-й переулок 	завулак
Купалаўскі 3-і завулак 	Купаловский 3-й переулок 	завулак
Купалаўскі 4-ы завулак 	Купаловский 4-й переулок 	завулак
Купальская вуліца 	Купальская улица 	вуліца
Лазо вуліца 	Лазо улица 	вуліца
Лазовая вуліца 	Лозовая улица 	вуліца
Лазовы завулак 	Лозовой переулок 	завулак
Лакціёнава вуліца 	Лактионова улица 	вуліца
Ламаносава вуліца 	Ломоносова улица 	вуліца
Ламаносава завулак 	Ломоносова переулок 	завулак
Ландшафтная вуліца 	Ландшафтная улица 	вуліца
Ландышавая вуліца 	Ландышевая улица 	вуліца
Лаўровая вуліца 	Лавровая улица 	вуліца
Лебядзіная вуліца 	Лебединая улица 	вуліца
Лебядзіны завулак 	Лебединый переулок 	завулак
Леванеўскага вуліца 	Леваневского улица 	вуліца
Лейтэнанта Акімачкіна вуліца 	Лейтенанта Акимочкина улица 	вуліца
Лейтэнанта Рабцава вуліца 	Лейтенанта Рябцева улица 	вуліца
Леніна вуліца 	Ленина улица 	вуліца
Леніна плошча 	Ленина площадь 	плошча
Ленінградская вуліца 	Ленинградская улица 	вуліца
Летняя вуліца 	Летняя улица 	вуліца
Лётная вуліца 	Лётная улица 	вуліца
Лётны завулак 	Лётный переулок 	завулак
Лідская вуліца 	Лидская улица 	вуліца
Лізы Чайкінай вуліца 	Лизы Чайкиной улица 	вуліца
Ліловая вуліца 	Лиловая улица 	вуліца
Лінейная вуліца 	Линейная улица 	вуліца
Ліпавая вуліца 	Липовая улица 	вуліца
Ліпеньская вуліца 	Июльская улица 	вуліца
Лірычная вуліца 	Лирическая улица 	вуліца
Лірычны завулак 	Лирический переулок 	завулак
Лугавая вуліца 	Луговая улица 	вуліца
Лугавы завулак 	Луговой переулок 	завулак
Лунная вуліца 	Лунная улица 	вуліца
Луцкая вуліца 	Луцкая улица 	вуліца
Лучынскага вуліца 	Лучинского улица 	вуліца
Лысая гара вуліца 	Лысая гора улица 	вуліца
Лысая гара завулак 	Лысая гора переулок 	завулак
Лышчыцкая вуліца 	Лыщицкая улица 	вуліца
Лышчыцкі 1-ы завулак 	Лыщицкий 1-й переулок 	завулак
Лышчыцкі 2-і завулак 	Лыщицкий 2-й переулок 	завулак
Лышчыцкі 3-і завулак 	Лыщицкий 3-й переулок 	завулак
Лышчыцкі 4-ы завулак 	Лыщицкий 4-й переулок 	завулак
Лышчыцкі 5-ы завулак 	Лыщицкий 5-й переулок 	завулак
Лышчыцкі 6-ы завулак 	Лыщицкий 6-й переулок 	завулак
Лышчыцкі праезд 	Лыщицкий проезд 	праезд
Льва Талстога вуліца 	Льва Толстого улица 	вуліца
Люстраная вуліца 	Зеркальная улица 	вуліца
Лясная вуліца 	Лесная улица 	вуліца
Лясны завулак 	Лесной переулок 	завулак
МАДРа вуліца 	МОПРа улица 	вуліца
Мазурука вуліца 	Мазурука улица 	вуліца
Максіма Багдановіча вуліца 	Максима Богдановича улица 	вуліца
Максіма Багдановіча завулак 	Максима Богдановича переулок 	завулак
Маладагвардзейская вуліца 	Молодогвардейская улица 	вуліца
Маладзёжная вуліца 	Молодежная улица 	вуліца
Маладзёжны завулак 	Молодёжный переулок 	завулак
Маларыцкая вуліца 	Малоритская улица 	вуліца
Малахітавая вуліца 	Малахитовая улица 	вуліца
Малая вуліца 	Малая улица 	вуліца
Малінавая вуліца 	Малиновая улица 	вуліца
Манастырская вуліца 	Монастырская улица 	вуліца
Марозава вуліца 	Морозова улица 	вуліца
Маскоўская вуліца 	Московская улица 	вуліца
Маставая вуліца 	Мостовая улица 	вуліца
Матросава вуліца 	Матросова улица 	вуліца
Матросава завулак 	Матросова переулок 	завулак
Матыкальская вуліца 	Мотыкальская улица 	вуліца
Махновіча вуліца 	Махновича улица 	вуліца
Машчонка вуліца 	Мощёнка улица 	вуліца
Машчонкаўская вуліца 	Мощёнковская улица 	вуліца
Машэнскага вуліца 	Мошенского улица 	вуліца
Машэрава праспект 	Машерова проспект 	праспект
Маякоўскага вуліца 	Маяковского улица 	вуліца
Меднаўская вуліца 	Медновская улица 	вуліца
Медыцынская вуліца 	Медицинская улица 	вуліца
Межавая вуліца 	Межевая улица 	вуліца
Межавы завулак 	Межевой переулок 	завулак
Мележа вуліца 	Мележа улица 	вуліца
Мянжынскага вуліца 	Менжинского улица 	вуліца
Мікалаеўская вуліца 	Николаевская улица 	вуліца
Мінскі 1-ы завулак 	Минский 1-й переулок 	завулак
Мінскі 2-і завулак 	Минский 2-й переулок 	завулак
Мірная вуліца 	Мирная улица 	вуліца
Мірны завулак 	Мирный переулок 	завулак
Мірская вуліца 	Мирская улица 	вуліца
Міру завулак 	Мира переулок 	завулак
Міхайлаўская вуліца 	Михайловская улица 	вуліца
Міцкевіча вуліца 	Мицкевича улица 	вуліца
Міцькі вуліца 	Митьки улица 	вуліца
Мічурына вуліца 	Мичурина улица 	вуліца
Мусаргскага вуліца 	Мусоргского улица 	вуліца
Мусаргскага завулак 	Мусоргского переулок 	завулак
Мухавецкая вуліца 	Мухавецкая улица 	вуліца
Мытная вуліца 	Мытная улица 	вуліца
Мядовая вуліца 	Медовая улица 	вуліца
Набярэжная вуліца 	Набережная улица 	вуліца
Набярэжны завулак 	Набережный переулок 	завулак
Навасельская вуліца 	Новосельская улица 	вуліца
Навасёлаў вуліца 	Новосёлов улица 	вуліца
Навасёлаў завулак 	Новосёлов переулок 	завулак
Навасёлкаўская вуліца 	Новосёлковская улица 	вуліца
Наганава вуліца 	Наганова улица 	вуліца
Надзеждзінская вуліца 	Надеждинская улица 	вуліца
Надзеждзінскі завулак 	Надеждинский переулок 	завулак
Надзеждзінскі праезд 	Надеждинский проезд 	праезд
Надзеі вуліца 	Надежды улица 	вуліца
Напалеона Орды вуліца 	Напалеона Орды улица 	вуліца
Нарачанская вуліца 	Нарочанская улица 	вуліца
Народная вуліца 	Народная улица 	вуліца
Настаўніцкая вуліца 	Учительская улица 	вуліца
Настаўніцкі завулак 	Учительский переулок 	завулак
Настаўніцкі 2-і завулак 	Учительский 2-й переулок 	завулак
Нафтавая вуліца 	Нефтяная улица 	вуліца
Нектарная вуліца 	Нектарная улица 	вуліца
Несцерчука вуліца 	Нестерчука улица 	вуліца
Нізкі завулак 	Низкий переулок 	завулак
Нікольская вуліца 	Никольская улица 	вуліца
Новазадворская вуліца 	Новозадворская улица 	вуліца
Новая вуліца 	Новая улица 	вуліца
Новая 1-я вуліца 	Новая 1-я улица 	вуліца
Новая Аркадзія вуліца 	Новая Аркадия улица 	вуліца
Някрасава вуліца 	Некрасова улица 	вуліца
Нямцэвіча вуліца 	Немцевича улица 	вуліца
Пагранічная вуліца 	Пограничная улица 	вуліца
Пагранічны 1-ы завулак 	Пограничный 1-й переулок 	завулак
Пагранічны 2-і завулак 	Пограничный 2-й переулок 	завулак
Пагранічны 3-і завулак 	Пограничный 3-й переулок 	завулак
Пагранічны 4-ы завулак 	Пограничный 4-й переулок 	завулак
Падбусынская вуліца 	Подбусынская улица 	вуліца
Падгародская вуліца 	Подгородская улица 	вуліца
Падляская вуліца 	Подлясская улица 	вуліца
Пакроўская вуліца 	Покровская улица 	вуліца
Палеская вуліца 	Полесская улица 	вуліца
Палявая вуліца 	Полевая улица 	вуліца
Палявы завулак 	Полевой переулок 	завулак
Палянская вуліца 	Полянская улица 	вуліца
Палярная вуліца 	Полярная улица 	вуліца
Паляўнічая вуліца 	Охотничья улица 	вуліца
Панфілава завулак 	Панфилова переулок 	завулак
Панфілаўцаў вуліца 	Панфиловцев улица 	вуліца
Папаніна вуліца 	Папанина улица 	вуліца
Паплаўскага вуліца 	Поплавского улица 	вуліца
Паркавая вуліца 	Парковая улица 	вуліца
Паркавы 1-ы завулак 	Парковый 1-й переулок 	завулак
Паркавы 2-і завулак 	Парковый 2-й переулок 	завулак
Партызанская вуліца 	Партизанская улица 	вуліца
Партызанскі праспект 	Партизанский проспект 	праспект
Пархоменкі вуліца 	Пархоменко улица 	вуліца
Пархоменкі завулак 	Пархоменко переулок 	завулак
Пастарнацкага вуліца 	Пастернацкого улица 	вуліца
Паўднёвая вуліца 	Южная улица 	вуліца
Паўднёвы завулак 	Южный переулок 	завулак
Паўднёвы праезд 	Южный проезд 	праезд
Паўлаўская вуліца 	Павловская улица 	вуліца
Паўночная вуліца 	Северная улица 	вуліца
Паўночны 1-ы завулак 	Северный 1-й переулок 	завулак
Паўночны 2-і завулак 	Северный 2-й переулок 	завулак
Паўночны 3-і завулак 	Северный 3-й переулок 	завулак
Паўночны 4-ы завулак 	Северный 4-й переулок 	завулак
Паўночны 5-ы завулак 	Северный 5-й переулок 	завулак
Паўночны 6-ы завулак 	Северный 6-й переулок 	завулак
Паўночны 7-ы завулак 	Северный 7-й переулок 	завулак
Паўночны 8-ы завулак 	Северный 8-й переулок 	завулак
Першамайская вуліца 	Первомайская улица 	вуліца
Першамайская 1-я вуліца 	Первомайская 1-я улица 	вуліца
Першамайская 2-я вуліца 	Первомайская 2-я улица 	вуліца
Першамайская 3-я вуліца 	Первомайская 3-я улица 	вуліца
Першамайская 4-я вуліца 	Первомайская 4-я улица 	вуліца
Петрапаўлаўская вуліца 	Петропавловская улица 	вуліца
Піваварная вуліца 	Пивоварная улица 	вуліца
Пісьменніка Смірнова вуліца 	Писателя Смирнова улица 	вуліца
Пісьменніка Смірнова завулак 	Писателя Смирнова переулок 	завулак
Піхтавая вуліца 	Пихтовая улица 	вуліца
Піянерская вуліца 	Пионерская улица 	вуліца
Піянерскі завулак 	Пионерский переулок 	завулак
Пладовая вуліца 	Плодовая улица 	вуліца
Платанавая вуліца 	Платановая улица 	вуліца
Плоска вуліца 	Плоска улица 	вуліца
Полацкая вуліца 	Полоцкая улица 	вуліца
Пралескавая вуліца 	Пролесковая улица 	вуліца
Пралескавы завулак 	Пролесковый переулок 	завулак
Пралетарская вуліца 	Пролетарская улица 	вуліца
Прамысловая вуліца 	Промышленная улица 	вуліца
Прамяністая вуліца 	Лучистая улица 	вуліца
Пранягіна вуліца 	Пронягина улица 	вуліца
Прасторная вуліца 	Просторная улица 	вуліца
Прахадная вуліца 	Проходная улица 	вуліца
Прахадная 1-я вуліца 	Проходная 1-я улица 	вуліца
Прахадная 2-я вуліца 	Проходная 2-я улица 	вуліца
Прахалодная вуліца 	Прохладная улица 	вуліца
Працоўная вуліца 	Трудовая улица 	вуліца
Працоўная 1-я вуліца 	Трудовая 1-я улица 	вуліца
Працоўная 2-я вуліца 	Трудовая 2-я улица 	вуліца
Працоўная 3-я вуліца 	Трудовая 3-я улица 	вуліца
Працы завулак 	Труда переулок 	завулак
Пружанская вуліца 	Пружанская улица 	вуліца
Прыазёрная вуліца 	Приозёрная улица 	вуліца
Прыбужская вуліца 	Прибужская улица 	вуліца
Прыбярэжная вуліца 	Прибрежная улица 	вуліца
Прыбярэжны завулак 	Прибрежный переулок 	завулак
Прывакзальная плошча 	Привокзальная площадь 	плошча
Прыветлівая вуліца 	Приветливая улица 	вуліца
Прыгарадная вуліца 	Пригородная улица 	вуліца
Прыгранічная вуліца 	Приграничная улица 	вуліца
Прыгранічны 1-ы завулак 	Приграничный 1-й переулок 	завулак
Прыгранічны 2-і завулак 	Приграничный 2-й переулок 	завулак
Прыдарожная вуліца 	Придорожная улица 	вуліца
Пташука вуліца 	Пташука улица 	вуліца
Пуганава вуліца 	Пуганова улица 	вуліца
Пугачоўская вуліца 	Пугачёвская улица 	вуліца
Пунсовая вуліца 	Алая улица 	вуліца
Пуцейская вуліца 	Путейская улица 	вуліца
Пуцейскі завулак 	Путейский переулок 	завулак
Пуцявая вуліца 	Путевая улица 	вуліца
Пушкінская вуліца 	Пушкинская улица 	вуліца
Пушчанская вуліца 	Пущанская улица 	вуліца
Пушчанскі 1-ы завулак 	Пущанский 1-й переулок 	завулак
Пушчанскі 2-і завулак 	Пущанский 2-й переулок 	завулак
Пшанічны завулак 	Пшеничный переулок 	завулак
Пясочная вуліца 	Песочная улица 	вуліца
Пясчаная вуліца 	Песчаная улица 	вуліца
Пятроўская вуліца 	Петровская улица 	вуліца
Рабінавая вуліца 	Рябиновая улица 	вуліца
Рабочая вуліца 	Рабочая улица 	вуліца
Радасная вуліца 	Отрадная улица 	вуліца
Радужная вуліца 	Радужная улица 	вуліца
Радужны завулак 	Радужный переулок 	завулак
Радужны 2-і завулак 	Радужный 2-й переулок 	завулак
Радыяльная вуліца 	Радиальная улица 	вуліца
Раждзественскі 1-ы завулак 	Рождественский 1-й переулок 	завулак
Ракасоўскага вуліца 	Рокоссовского улица 	вуліца
Ракітная вуліца 	Ракитная улица 	вуліца
Раманаўская вуліца 	Романовская улица 	вуліца
Рамонкавая вуліца 	Ромашковая улица 	вуліца
Ранішняя вуліца 	Утренняя улица 	вуліца
Рачная вуліца 	Речная улица 	вуліца
Рачны 1-ы завулак 	Речной 1-й переулок 	завулак
Рачны 2-і завулак 	Речной 2-й переулок 	завулак
Руж завулак 	Роз переулок 	завулак
Ружанская вуліца 	Ружанская улица 	вуліца
Ружанская 1-я вуліца 	Ружанская 1-я улица 	вуліца
Ружовая вуліца 	Розовая улица 	вуліца
Рэпіна вуліца 	Репина улица 	вуліца
Рэспубліканская вуліца 	Республиканская улица 	вуліца
Рэспублікі праспект 	Республики проспект 	праспект
Рэчыцкая вуліца 	Речицкая улица 	вуліца
Савецкай Канстытуцыі вуліца 	Советской Конституции улица 	вуліца
Савецкая вуліца 	Советская улица 	вуліца
Савецкіх пагранічнікаў вуліца 	Советских Пограничников улица 	вуліца
Садовая вуліца 	Садовая улица 	вуліца
Садовы завулак 	Садовый переулок 	завулак
Садовы 1-ы завулак 	Садовый 1-й переулок 	завулак
Садовы 2-і завулак 	Садовый 2-й переулок 	завулак
Садовы 3-і завулак 	Садовый 3-й переулок 	завулак
Салаўіны завулак 	Соловьиный переулок 	завулак
Салтыкова-Шчадрына вуліца 	Салтыкова-Щедрина улица 	вуліца
Сальнікава вуліца 	Сальникова улица 	вуліца
Самшытавая вуліца 	Самшитовая улица 	вуліца
Сардэчная вуліца 	Сердечная улица 	вуліца
Сасновая вуліца 	Сосновая улица 	вуліца
Сасновы завулак 	Сосновый переулок 	завулак
Свабоды плошча 	Свободы площадь 	плошча
Светлая вуліца 	Светлая улица 	вуліца
Свінарчука вуліца 	Свинарчука улица 	вуліца
Світальная вуліца 	Рассветная улица 	вуліца
Свярдлова вуліца 	Свердлова улица 	вуліца
Свята-Афанасьеўская вуліца 	Свято-Афанасьевская улица 	вуліца
Свята-Нікіфараўская вуліца 	Свято-Никифоровская улица 	вуліца
Серабрысты завулак 	Серебристый переулок 	завулак
Серафіма Сароўскага вуліца 	Серафима Саровского улица 	вуліца
Сікорскага вуліца 	Сикорского улица 	вуліца
Скрыпнікава вуліца 	Скрипникова улица 	вуліца
Слабодская вуліца 	Слободская улица 	вуліца
Славянская вуліца 	Славянская улица 	вуліца
Слуцкая вуліца 	Слуцкая улица 	вуліца
Смаляны завулак 	Смоляной переулок 	завулак
Снежная вуліца 	Снежная улица 	вуліца
Сонечная вуліца 	Солнечная улица 	вуліца
Сонечны завулак 	Солнечный переулок 	завулак
Спакойная вуліца 	Спокойная улица 	вуліца
Спартыўная вуліца 	Спортивная улица 	вуліца
Сталічная вуліца 	Столичная улица 	вуліца
Станцыйная вуліца 	Станционная улица 	вуліца
Старадарожная вуліца 	Стародорожная улица 	вуліца
Старажытная вуліца 	Старожитная улица 	вуліца
Старазадворская вуліца 	Старозадворская улица 	вуліца
Старазадворскі завулак 	Старозадворский переулок 	завулак
Старасельская вуліца 	Старосельская улица 	вуліца
Стараславянская вуліца 	Старославянская улица 	вуліца
Стафеева вуліца 	Стафеева улица 	вуліца
Столінская вуліца 	Столинская улица 	вуліца
Стралковы завулак 	Стрелковый переулок 	завулак
Студэнцкі завулак 	Студенческий переулок 	завулак
Суворава вуліца 	Суворова улица 	вуліца
Суворава завулак 	Суворова переулок 	завулак
Сунічная вуліца 	Суничная улица 	вуліца
Сустрэчная вуліца 	Встречная улица 	вуліца
Сяброўская вуліца 	Сябровская улица 	вуліца
Сядзібная вуліца 	Усадебная улица 	вуліца
Сялянская вуліца 	Крестьянская улица 	вуліца
Сярэдняя вуліца 	Средняя улица 	вуліца
Тамашоўская вуліца 	Томашовская улица 	вуліца
Тапаліная вуліца 	Тополиная улица 	вуліца
Тарнапольскага вуліца 	Тарнопольского улица 	вуліца
Тарфяная вуліца 	Торфяная улица 	вуліца
Тарфяны завулак 	Торфяной переулок 	завулак
Таццянінская вуліца 	Татьянинская улица 	вуліца
Травяная вуліца 	Травяная улица 	вуліца
Троіцкая вуліца 	Троицкая улица 	вуліца
Трысняговая вуліца 	Тростниковая улица 	вуліца
Трышынская вуліца 	Тришинская улица 	вуліца
Тургенева вуліца 	Тургенева улица 	вуліца
Турыстычная вуліца 	Туристическая улица 	вуліца
Тэатральная вуліца 	Театральная улица 	вуліца
Тэльмана вуліца 	Тельмана улица 	вуліца
Узыходная вуліца 	Восходящая улица 	вуліца
Уладаўская вуліца 	Влодавская улица 	вуліца
Уладзімірская вуліца 	Владимирская улица 	вуліца
Ураджайная вуліца 	Урожайная улица 	вуліца
Урублеўскага вуліца 	Врублевского улица 	вуліца
Урыцкага вуліца 	Урицкого улица 	вуліца
Успенская вуліца 	Успенская улица 	вуліца
Усходняя вуліца 	Восточная улица 	вуліца
Фаміна вуліца 	Фомина улица 	вуліца
Фартэчная вуліца 	Фортечная улица 	вуліца
Фартэчны завулак 	Фортечный переулок 	завулак
Філатава вуліца 	Филатова улица 	вуліца
Філатава завулак 	Филатова переулок 	завулак
Фортавая вуліца 	Фортовая улица 	вуліца
Францішка Скарыны набярэжная 	Франциска Скорины набережная 	набярэжная
Фруктовая вуліца 	Фруктовая улица 	вуліца
Фрунзэ вуліца 	Фрунзе улица 	вуліца
Халтурына вуліца 	Халтурина улица 	вуліца
Хвойная вуліца 	Хвойная улица 	вуліца
Хлебная 1-я вуліца 	Хлебная 1-я улица 	вуліца
Хлебная 2-я вуліца 	Хлебная 2-я улица 	вуліца
Хлебная 3-я вуліца 	Хлебная 3-я улица 	вуліца
Хлебная 4-я вуліца 	Хлебная 4-я улица 	вуліца
Холмская вуліца 	Холмская улица 	вуліца
Хрустальная вуліца 	Хрустальная улица 	вуліца
Цагляная вуліца 	Кирпичная улица 	вуліца
Цалінная вуліца 	Целинная улица 	вуліца
Целяханская вуліца 	Телеханская улица 	вуліца
Ціміразева вуліца 	Тимирязева улица 	вуліца
Цісавая вуліца 	Тисовая улица 	вуліца
Ціхая вуліца 	Тихая улица 	вуліца
Ціхі завулак 	Тихий переулок 	завулак
Цэнтральная вуліца 	Центральная улица 	вуліца
Цэнтральны завулак 	Центральный переулок 	завулак
Цюльпанавая вуліца 	Тюльпановая улица 	вуліца
Цяністая вуліца 	Тенистая улица 	вуліца
Цяністы завулак 	Тенистый переулок 	завулак
Цяністы 1-ы завулак 	Тенистый 1-й переулок 	завулак
Цяплічная вуліца 	Тепличная улица 	вуліца
Цярэспальская вуліца 	Тереспольская улица 	вуліца
Цярэспальскі завулак 	Тереспольский переулок 	завулак
Чайкоўскага вуліца 	Чайковского улица 	вуліца
Чапаева вуліца 	Чапаева улица 	вуліца
Чарнігаўская вуліца 	Черниговская улица 	вуліца
Чарнянская вуліца 	Чернянская улица 	вуліца
Чарняхоўскага вуліца 	Черняховского улица 	вуліца
Чаромхавая вуліца 	Черёмуховая улица 	вуліца
Чаротавая вуліца 	Камышовая улица 	вуліца
Чкалава вуліца 	Чкалова улица 	вуліца
Чыгуначная вуліца 	Железнодорожная улица 	вуліца
Чыгуначны 1-ы завулак 	Железнодорожный 1-й переулок 	завулак
Чыгуначны 2-і завулак 	Железнодорожный 2-й переулок 	завулак
Чыгуначны 3-і завулак 	Железнодорожный 3-й переулок 	завулак
Чыгуначны 4-ы завулак 	Железнодорожный 4-й переулок 	завулак
Чырванафлоцкая вуліца 	Краснофлотская улица 	вуліца
Чырвонагвардзейская вуліца 	Красногвардейская улица 	вуліца
Чырвонагвардзейскі завулак 	Красногвардейский переулок 	завулак
Чырвонасцяжная вуліца 	Краснознаменная улица 	вуліца
Чырвоная вуліца 	Красная улица 	вуліца
Чырвоны завулак 	Красный переулок 	завулак
Чыстапрудная вуліца 	Чистопрудная улица 	вуліца
Чыстая вуліца 	Чистая улица 	вуліца
Чычэрына вуліца 	Чичерина улица 	вуліца
Чэлюскіна вуліца 	Челюскина улица 	вуліца
Чэхава вуліца 	Чехова улица 	вуліца
Шаблоўскага вуліца 	Шабловского улица 	вуліца
Шасэйная вуліца 	Шоссейная улица 	вуліца
Шаўчэнкі бульвар 	Шевченко бульвар 	бульвар
Шаўчэнкі вуліца 	Шевченко улица 	вуліца
Шафранавая вуліца 	Шафрановая улица 	вуліца
Школьная вуліца 	Школьная улица 	вуліца
Школьны завулак 	Школьный переулок 	завулак
Школьны 1-ы завулак 	Школьный 1-й переулок 	завулак
Шлюзавая вуліца 	Шлюзовая улица 	вуліца
Шолахава вуліца 	Шолохова улица 	вуліца
Шчорса вуліца 	Щорса улица 	вуліца
Шырокая вуліца 	Широкая улица 	вуліца
Шышкіна вуліца 	Шишкина улица 	вуліца
Шэрая вуліца 	Серая улица 	вуліца
Энгельса вуліца 	Энгельса улица 	вуліца
Энергетыкаў вуліца 	Энергетиков улица 	вуліца
Энергетыкаў завулак 	Энергетиков переулок 	завулак
Энтузіястаў вуліца 	Энтузиастов улица 	вуліца
Юбілейная вуліца 	Юбилейная улица 	вуліца
Юбілейны завулак 	Юбилейный переулок 	завулак
Яблыневая вуліца 	Яблоневая улица 	вуліца
Ягадная вуліца 	Ягодная улица 	вуліца
Ядлаўцовая вуліца 	Можжевеловая улица 	вуліца
Язмінавая вуліца 	Жасминовая улица 	вуліца
Якуба Коласа вуліца 	Якуба Коласа улица 	вуліца
Яловая вуліца 	Еловая улица 	вуліца
Янкі Купалы вуліца 	Янки Купалы улица 	вуліца
Янкі Купалы завулак 	Янки Купалы переулок 	завулак
Янтарная вуліца 	Янтарная улица 	вуліца
Ясеневая вуліца 	Ясеневая улица 	вуліца
Ясеніна вуліца 	Есенина улица 	вуліца
Ясеніна завулак 	Есенина переулок 	завулак
Яснагорская вуліца 	Ясногорская улица 	вуліца
Яснагорскі 1-ы завулак 	Ясногорский 1-й переулок 	завулак
Яснагорскі 2-і завулак 	Ясногорский 2-й переулок 	завулак
Яснагорскі 3-і завулак 	Ясногорский 3-й переулок 	завулак
Яснагорскі 4-ы завулак 	Ясногорский 4-й переулок 	завулак
Яснагорскі 5-ы завулак 	Ясногорский 5-й переулок 	завулак
Яснагорскі праезд 	Ясногорский проезд 	праезд
Ясная вуліца 	Ясная улица 	вуліца