3 Верасня вуліца 	3 Сентября улица 	вуліца
3 Верасня завулак 	3 Сентября переулок 	завулак
17 Верасня бульвар 	17 Сентября бульвар 	бульвар
50 год Перамогі вуліца 	50 лет Победы улица 	вуліца
Аб’яднаных нацый плошча 	Объединенных наций площадь 	плошча
Абрыкосавая вуліца 	Абрикосовая улица 	вуліца
Абухоўская вуліца 	Обуховская улица 	вуліца
Абухоўскі 1-ы завулак 	Обуховский 1-й переулок 	завулак
Абухоўскі 3-і завулак 	Обуховский 3-й переулок 	завулак
Абухоўскі 4-ы завулак 	Обуховский 4-й переулок 	завулак
Авакяна вуліца 	Авакяна улица 	вуліца
Авангардная вуліца 	Авангардная улица 	вуліца
Авангардны завулак 	Авангардный переулок 	завулак
Авіяцыі вуліца 	Авиации улица 	вуліца
Агарова вуліца 	Огарёва улица 	вуліца
Агародніцкая вуліца 	Огородницкая улица 	вуліца
Агатавы завулак 	Агатовый переулок 	завулак
Агінскага вуліца 	Огинского улица 	вуліца
Адама Шэмеша вуліца 	Адама Шемеша улица 	вуліца
Адзінцова вуліца 	Одинцова улица 	вуліца
Адзінцова завулак 	Одинцова переулок 	завулак
Адоеўскага вуліца 	Одоевского улица 	вуліца
Адоеўскага завулак 	Одоевского переулок 	завулак
Адэская вуліца 	Одесская улица 	вуліца
Адэскі завулак 	Одесский переулок 	завулак
Адэскі праезд 	Одесский проезд 	праезд
Азгура вуліца 	Азгура улица 	вуліца
Азёрная вуліца 	Озёрная улица 	вуліца
Азёрны завулак 	Озёрный переулок 	завулак
Азізава вуліца 	Азизова улица 	вуліца
Азоўская вуліца 	Азовская улица 	вуліца
Азярцоўскі тракт 	Озерцовский тракт 	тракт
Айвазоўскага вуліца 	Айвазовского улица 	вуліца
Айвазоўскага завулак 	Айвазовского переулок 	завулак
Акадэміка Высоцкага вуліца 	Академика Высоцкого улица 	вуліца
Акадэміка Вышалескага вуліца 	Академика Вышелесского улица 	вуліца
Акадэміка Вышалескага завулак 	Академика Вышелесского переулок 	завулак
Акадэміка Жэбрака вуліца 	Академика Жебрака улица 	вуліца
Акадэміка Жэбрака завулак 	Академика Жебрака переулок 	завулак
Акадэміка Карскага вуліца 	Академика Карского улица 	вуліца
Акадэміка Красіна вуліца 	Академика Красина улица 	вуліца
Акадэміка Купрэвіча вуліца 	Академика Купревича улица 	вуліца
Акадэміка Курчатава вуліца 	Академика Курчатова улица 	вуліца
Акадэміка Фёдарава вуліца 	Академика Фёдорова улица 	вуліца
Акадэмічная вуліца 	Академическая улица 	вуліца
Акружны праезд 	Окружной проезд 	праезд
Акрэсціна 1-ы завулак 	Окрестина 1-й переулок 	завулак
Акрэсціна вуліца 	Окрестина улица 	вуліца
Аладавых вуліца 	Аладовых улица 	вуліца
Алаізы Пашкевіч вуліца 	Алоизы Пашкевич улица 	вуліца
Алега Кашавога вуліца 	Олега Кошевого улица 	вуліца
Алейная вуліца 	Аллейная улица 	вуліца
Алеся Бачылы вуліца 	Алеся Бачило улица 	вуліца
Алеся Гаруна вуліца 	Алеся Гаруна улица 	вуліца
Алеся Дудара вуліца 	Алеся Дудара улица 	вуліца
Алібегава вуліца 	Алибегова улица 	вуліца
Алтайская вуліца 	Алтайская улица 	вуліца
Алтайскі завулак 	Алтайский переулок 	завулак
Альховая вуліца 	Ольховая улица 	вуліца
Альшанская вуліца 	Ольшанская улица 	вуліца
Альшэўскага вуліца 	Ольшевского улица 	вуліца
Альшэўскага завулак 	Ольшевского переулок 	завулак
Аляксандраўская вуліца 	Александровская улица 	вуліца
Амбулаторная вуліца 	Амбулаторная улица 	вуліца
Амбулаторны завулак 	Амбулаторный переулок 	завулак
Амельянюка вуліца 	Омельянюка улица 	вуліца
Амуратарская вуліца 	Амураторская улица 	вуліца
Амурская вуліца 	Амурская улица 	вуліца
Амурскі завулак 	Амурский переулок 	завулак
Анаева вуліца 	Аннаева улица 	вуліца
Ангарская вуліца 	Ангарская улица 	вуліца
Ангарскі завулак 	Ангарский переулок 	завулак
Андрэеўская вуліца 	Андреевская улица 	вуліца
Антонаўская вуліца 	Антоновская улица 	вуліца
Антоненкі вуліца 	Антоненко улица 	вуліца
Апалінар’еўская вуліца 	Аполинарьевская улица 	вуліца
Аранжарэйная вуліца 	Оранжерейная улица 	вуліца
Аранская вуліца 	Аранская улица 	вуліца
Арджанікідзэ вуліца 	Орджоникидзе улица 	вуліца
Аркадзя Смоліча вуліца 	Аркадия Смолича улица 	вуліца
Арктычная 1-я вуліца 	Арктическая 1-я улица 	вуліца
Арлоўская вуліца 	Орловская улица 	вуліца
Арлоўскі 3-і завулак 	Орловский 3-й переулок 	завулак
Арлоўскі 4-ы завулак 	Орловский 4-й переулок 	завулак
Арлоўскі 5-ы завулак 	Орловский 5-й переулок 	завулак
Арлоўскі 6-ы завулак 	Орловский 6-й переулок 	завулак
Арлоўскі 7-ы завулак 	Орловский 7-й переулок 	завулак
Арлоўскі 8-ы завулак 	Орловский 8-й переулок 	завулак
Артылерыстаў вуліца 	Артиллеристов улица 	вуліца
Архітэктара Заборскага вуліца 	Архитектора Заборского улица 	вуліца
Арцёма 1-ы завулак 	Артёма 1-й переулок 	завулак
Арцёма 1-ы праезд 	Артёма 1-й проезд 	праезд
Арцёма вуліца 	Артёма улица 	вуліца
Аршанская вуліца 	Оршанская улица 	вуліца
Аршанскі праезд 	Оршанский проезд 	праезд
Асаналіева вуліца 	Асаналиева улица 	вуліца
Асаналіева завулак 	Асаналиева переулок 	завулак
Асвейская вуліца 	Освейская улица 	вуліца
Асенні 1-ы завулак 	Осенний 1-й переулок 	завулак
Асенні 2-і завулак 	Осенний 2-й переулок 	завулак
Асенняя вуліца 	Осенняя улица 	вуліца
Асіпенка вуліца 	Осипенко улица 	вуліца
Асіповіцкая вуліца 	Осиповичская улица 	вуліца
Астрашыцкая вуліца 	Острошицкая улица 	вуліца
Астрожскіх вуліца 	Острожских улица 	вуліца
Аўрораўская вуліца 	Авроровская улица 	вуліца
Аўтадораўская вуліца 	Автодоровская улица 	вуліца
Аўтадораўскі завулак 	Автодоровский переулок 	завулак
Аўтазаводская вуліца 	Автозаводская улица 	вуліца
Аўтазаводскі завулак 	Автозаводской переулок 	завулак
Аўтамабілістаў вуліца 	Автомобилистов улица 	вуліца
Аўэзава вуліца 	Ауэзова улица 	вуліца
Ахоцкая вуліца 	Охотская улица 	вуліца
Ахоцкі завулак 	Охотский переулок 	завулак
Ашмянскі завулак 	Ошмянский переулок 	завулак
Аэрадромная вуліца 	Аэродромная улица 	вуліца
Аэрадромны завулак 	Аэродромный переулок 	завулак
Аэрафлоцкая вуліца 	Аэрофлотская улица 	вуліца
Аэрафлоцкі 1-ы завулак 	Аэрофлотский 1-й переулок 	завулак
Бабруйская вуліца 	Бобруйская улица 	вуліца
Бабушкіна вуліца 	Бабушкина улица 	вуліца
Багранцава вуліца 	Багрянцева улица 	вуліца
Баграціёна 1-ы завулак 	Багратиона 1-й переулок 	завулак
Баграціёна 2-і завулак 	Багратиона 2-й переулок 	завулак
Баграціёна вуліца 	Багратиона улица 	вуліца
Базісная 1-я вуліца 	Базисная 1-я улица 	вуліца
Базісная 2-я вуліца 	Базисная 2-я улица 	вуліца
Базісны завулак 	Базисный переулок 	завулак
Байкальская вуліца 	Байкальская улица 	вуліца
Бакінская вуліца 	Бакинская улица 	вуліца
Балотная вуліца 	Болотная улица 	вуліца
Балотнікава вуліца 	Болотникова улица 	вуліца
Балотнікава завулак 	Болотникова переулок 	завулак
Балтыйская вуліца 	Балтийская улица 	вуліца
Бальнічны завулак 	Больничный переулок 	завулак
Баляслава Берута вуліца 	Болеслава Берута улица 	вуліца
Бангалор плошча 	Бангалор площадь 	плошча
Баравецкі завулак 	Боровецкий переулок 	завулак
Барадзінская вуліца 	Бородинская улица 	вуліца
Барамзіной вуліца 	Барамзиной улица 	вуліца
Бараноўшчына вуліца 	Барановщина улица 	вуліца
Барвовая вуліца 	Багряная улица 	вуліца
Барвовы завулак 	Багряный переулок 	завулак
Басіялаўскі 1-ы завулак 	Басиаловский 1-й переулок 	завулак
Басіялаўскі 2-і завулак 	Басиаловский 2-й переулок 	завулак
Батанічная вуліца 	Ботаническая улица 	вуліца
Баторынская вуліца 	Баторинская улица 	вуліца
Баторынскі завулак 	Баторинский переулок 	завулак
Беламорская вуліца 	Беломорская улица 	вуліца
Беларуская вуліца 	Белорусская улица 	вуліца
Бельскага вуліца 	Бельского улица 	вуліца
Бельчыцкая вуліца 	Бельчицкая улица 	вуліца
Берасцянская вуліца 	Берестянская улица 	вуліца
Берсана вуліца 	Берсона улица 	вуліца
Бетонны праезд 	Бетонный проезд 	праезд
Бехцерава вуліца 	Бехтерева улица 	вуліца
Бехцерава завулак 	Бехтерева переулок 	завулак
Бібліятэчная вуліца 	Библиотечная улица 	вуліца
Бірузова вуліца 	Бирюзова улица 	вуліца
Брагінская вуліца 	Брагинская улица 	вуліца
Брагінскі 1-ы завулак 	Брагинский 1-й переулок 	завулак
Брагінскі 2-і завулак 	Брагинский 2-й переулок 	завулак
Браніслава Тарашкевіча вуліца 	Бронислава Тарашкевича улица 	вуліца
Бранявы завулак 	Броневой переулок 	завулак
Браслаўская вуліца 	Браславская улица 	вуліца
Брацкая вуліца 	Братская улица 	вуліца
Брацкі завулак 	Братский переулок 	завулак
Бровікава вуліца 	Бровикова улица 	вуліца
Брыкета вуліца 	Брикета улица 	вуліца
Брылеўская вуліца 	Брилевская улица 	вуліца
Брылеўскі тупік 	Брилевский тупик 	тупік
Брэст-Літоўская вуліца 	Брест-Литовская улица 	вуліца
Брэсцкая вуліца 	Брестская улица 	вуліца
Брэсцкі 1-ы завулак 	Брестский 1-й переулок 	завулак
Брэсцкі 2-і завулак 	Брестский 2-й переулок 	завулак
Брэсцкі 3-і завулак 	Брестский 3-й переулок 	завулак
Брэсцкі 4-ы завулак 	Брестский 4-й переулок 	завулак
Брэсцкі 5-ы завулак 	Брестский 5-й переулок 	завулак
Будаўнікоў вуліца 	Строителей улица 	вуліца
Будзённага вуліца 	Будённого улица 	вуліца
Будслаўская вуліца 	Будславская улица 	вуліца
Будслаўскі завулак 	Будславский переулок 	завулак
Бумажкова вуліца 	Бумажкова улица 	вуліца
Бумажкова завулак 	Бумажкова переулок 	завулак
Бумажкова праезд 	Бумажкова проезд 	праезд
Бурдзейнага вуліца 	Бурдейного улица 	вуліца
Быхаўская вуліца 	Быховская улица 	вуліца
Бэзавая вуліца 	Сиреневая улица 	вуліца
Бягомльская вуліца 	Бегомльская улица 	вуліца
Бялецкага вуліца 	Белецкого улица 	вуліца
Бялінскага вуліца 	Белинского улица 	вуліца
Бяляева вуліца 	Беляева улица 	вуліца
Бярозагорская вуліца 	Берёзогорская улица 	вуліца
Бярэзінская вуліца 	Березинская улица 	вуліца
Вавілава вуліца 	Вавилова улица 	вуліца
Вавілава завулак 	Вавилова переулок 	завулак
Вадалажскага вуліца 	Водолажского улица 	вуліца
Вайсковы завулак 	Войсковый переулок 	завулак
Вакзальная вуліца 	Вокзальная улица 	вуліца
Вакзальны 1-ы завулак 	Вокзальный 1-й переулок 	завулак
Валадарскага вуліца 	Володарского улица 	вуліца
Валадзько вуліца 	Володько улица 	вуліца
Валачаеўская вуліца 	Волочаевская улица 	вуліца
Валачаеўскі 3-і завулак 	Волочаевский 3-й переулок 	завулак
Валачаеўскі праезд 	Волочаевский проезд 	праезд
Валгаградская вуліца 	Волгоградская улица 	вуліца
Валгадонская вуліца 	Волгодонская улица 	вуліца
Валенція Ваньковіча вуліца 	Валентия Ваньковича улица 	вуліца
Валожынская вуліца 	Воложинская улица 	вуліца
Ванеева вуліца 	Ванеева улица 	вуліца
Ванеева плошча 	Ванеева площадь 	плошча
Варанянскага вуліца 	Воронянского улица 	вуліца
Варапаеўская вуліца 	Воропаевская улица 	вуліца
Варвашэні вуліца 	Варвашени улица 	вуліца
Васільковая вуліца 	Васильковая улица 	вуліца
Васняцова 1-ы завулак 	Васнецова 1-й переулок 	завулак
Васняцова 2-і завулак 	Васнецова 2-й переулок 	завулак
Васняцова вуліца 	Васнецова улица 	вуліца
Ватуціна вуліца 	Ватутина улица 	вуліца
Ватуціна завулак 	Ватутина переулок 	завулак
Ватуціна праезд 	Ватутина проезд 	праезд
Ваўпшасава вуліца 	Ваупшасова улица 	вуліца
Велазаводская вуліца 	Велозаводская улица 	вуліца
Веласіпедны 2-і завулак 	Велосипедный 2-й переулок 	завулак
Веласіпедны завулак 	Велосипедный переулок 	завулак
Велікаморская вуліца 	Великоморская улица 	вуліца
Верасовая вуліца 	Вересковая улица 	вуліца
Верашчагіна вуліца 	Верещагина улица 	вуліца
Вербная вуліца 	Вербная улица 	вуліца
Верхні завулак 	Верхний переулок 	завулак
Верхняя вуліца 	Верхняя улица 	вуліца
Веры Харужай вуліца 	Веры Хоружей улица 	вуліца
Весніна праезд 	Веснина проезд 	праезд
Веснінка вуліца 	Веснинка улица 	вуліца
Веснінка завулак 	Веснинка переулок 	завулак
Веснінка праезд 	Веснинка проезд 	праезд
Віктара Лівенцава вуліца 	Виктора Ливенцева улица 	вуліца
Віктара Турава вуліца 	Виктора Турова улица 	вуліца
Вілейская вуліца 	Вилейская улица 	вуліца
Вілкоўшчына вуліца 	Вилковщина улица 	вуліца
Вільямса 1-ы завулак 	Вильямса 1-й переулок 	завулак
Вільямса вуліца 	Вильямса улица 	вуліца
Вільямса завулак 	Вильямса переулок 	завулак
Вінаградная вуліца 	Виноградная улица 	вуліца
Вірская вуліца 	Вирская улица 	вуліца
Віцебская вуліца 	Витебская улица 	вуліца
Вішнёвы завулак 	Вишнёвый переулок 	завулак
Водазаборная вуліца 	Водозаборная улица 	вуліца
Водаправодны завулак 	Водопроводный переулок 	завулак
Возніцкая вуліца 	Извозная улица 	вуліца
Возніцкі 1-ы завулак 	Извозный 1-й переулок 	завулак
Возніцкі 2-і завулак 	Извозный 2-й переулок 	завулак
Возніцкі 3-і завулак 	Извозный 3-й переулок 	завулак
Воінаў-інтэрнацыяналістаў набярэжная 	Воинов-интернационалистов набережная 	набярэжная
Волаха вуліца 	Волоха улица 	вуліца
Волжская вуліца 	Волжская улица 	вуліца
Волжскі праезд 	Волжский проезд 	праезд
Вузаўскі завулак 	Вузовский переулок 	завулак
Вучнёўскі завулак 	Ученический переулок 	завулак
Выгоцкага вуліца 	Выготского улица 	вуліца
Вызвалення вуліца 	Освобождения улица 	вуліца
Высокая вуліца 	Высокая улица 	вуліца
Высокі завулак 	Высокий переулок 	завулак
Вязынская вуліца 	Вязынская улица 	вуліца
Вязынскі 1-ы завулак 	Вязынский 1-й переулок 	завулак
Вязынскі 2-і завулак 	Вязынский 2-й переулок 	завулак
Вялікая Слепня вуліца 	Большая Слепня улица 	вуліца
Вясенняя вуліца 	Весенняя улица 	вуліца
Вясёлкавая вуліца 	Радужная улица 	вуліца
Гагарына вуліца 	Гагарина улица 	вуліца
Газеты Звязда праспект 	Газеты Звязда проспект 	праспект
Газеты Праўда праспект 	Газеты Правда проспект 	праспект
Галавачова вуліца 	Головачёва улица 	вуліца
Галадзеда вуліца 	Голодеда улица 	вуліца
Галадзеда праезд 	Голодеда проезд 	праезд
Гало вуліца 	Гало улица 	вуліца
Гальшанская вуліца 	Гольшанская улица 	вуліца
Гальшанскі 1-ы завулак 	Гольшанский 1-й переулок 	завулак
Гальшанскі 2-і завулак 	Гольшанский 2-й переулок 	завулак
Гамарніка вуліца 	Гамарника улица 	вуліца
Гандлёвы завулак 	Торговый переулок 	завулак
Гарадзецкая вуліца 	Городецкая улица 	вуліца
Гарадскі Вал вуліца 	Городской Вал улица 	вуліца
Гараўца вуліца 	Горовца улица 	вуліца
Гарбатава вуліца 	Горбатова улица 	вуліца
Гастэлы вуліца 	Гастелло улица 	вуліца
Гая вуліца 	Гая улица 	вуліца
Гвардзейская вуліца 	Гвардейская улица 	вуліца
Гвардзейскі 1-ы завулак 	Гвардейский 1-й переулок 	завулак
Геалагічная вуліца 	Геологическая улица 	вуліца
Геалагічны завулак 	Геологический переулок 	завулак
Геалагічны праезд 	Геологический проезд 	праезд
Гебелева вуліца 	Гебелева улица 	вуліца
Генадзя Цітовіча вуліца 	Геннадия Цитовича улица 	вуліца
Генерала Антонава вуліца 	Генерала Антонова улица 	вуліца
Герасіменкі вуліца 	Герасименко улица 	вуліца
Германаўская 2-я вуліца 	Германовская 2-я улица 	вуліца
Германаўская вуліца 	Германовская улица 	вуліца
Германаўскі завулак 	Германовский переулок 	завулак
Герояў 120 Дывізіі вуліца 	Героев 120 Дивизии улица 	вуліца
Герояў Сталінграда вуліца 	Героев Сталинграда улица 	вуліца
Герцэна вуліца 	Герцена улица 	вуліца
Гікалы вуліца 	Гикало улица 	вуліца
Гінтаўта вуліца 	Гинтовта улица 	вуліца
Глаголева 2-і завулак 	Глаголева 2-й переулок 	завулак
Глаголева 3-і завулак 	Глаголева 3-й переулок 	завулак
Глаголева вуліца 	Глаголева улица 	вуліца
Глінішча праезд 	Глинище проезд 	праезд
Глыбоцкая вуліца 	Глубокская улица 	вуліца
Гогалеўская вуліца 	Гоголевская улица 	вуліца
Голубева вуліца 	Голубева улица 	вуліца
Горная вуліца 	Горная улица 	вуліца
Горны завулак 	Горный переулок 	завулак
Гродзенская вуліца 	Гродненская улица 	вуліца
Громава вуліца 	Громова улица 	вуліца
Грушаўская вуліца 	Грушевская улица 	вуліца
Грушаўскі завулак 	Грушевский переулок 	завулак
Грыбаедава вуліца 	Грибоедова улица 	вуліца
Грыбны завулак 	Грибной переулок 	завулак
Грызадубавай вуліца 	Гризодубовой улица 	вуліца
Грыцаўца вуліца 	Грицевца улица 	вуліца
Грэбелькі вуліца 	Гребельки улица 	вуліца
Грэкава 1-ы завулак 	Грекова 1-й переулок 	завулак
Грэкава 2-і завулак 	Грекова 2-й переулок 	завулак
Грэкава вуліца 	Грекова улица 	вуліца
Гурскага вуліца 	Гурского улица 	вуліца
Гурцьева вуліца 	Гуртьева улица 	вуліца
Гусоўскага вуліца 	Гусовского улица 	вуліца
Дабрамысленскі завулак 	Добромысленский переулок 	завулак
Даватара вуліца 	Доватора улица 	вуліца
Дакутовіч вуліца 	Докутович улица 	вуліца
Дакучаева вуліца 	Докучаева улица 	вуліца
Дальні завулак 	Дальний переулок 	завулак
Дамашэўская вуліца 	Домашевская улица 	вуліца
Дамашэўскі завулак 	Домашевский переулок 	завулак
Дамброўская вуліца 	Домбровская улица 	вуліца
Данілы Сердзіча вуліца 	Данилы Сердича улица 	вуліца
Дарашэвіча вуліца 	Дорошевича улица 	вуліца
Дароўская вуліца 	Даровская улица 	вуліца
Дароўскі завулак 	Даровский переулок 	завулак
Дастаеўскага вуліца 	Достоевского улица 	вуліца
Дастаеўскага завулак 	Достоевского переулок 	завулак
Даўгабродская вуліца 	Долгобродская улица 	вуліца
Даўгінаўскі 2-і завулак 	Долгиновский 2-й переулок 	завулак
Даўгінаўскі 3-і завулак 	Долгиновский 3-й переулок 	завулак
Даўгінаўскі 4-ы завулак 	Долгиновский 4-й переулок 	завулак
Даўгінаўскі праезд 	Долгиновский проезд 	праезд
Даўгінаўскі тракт 	Долгиновский тракт 	тракт
Даўмана вуліца 	Даумана улица 	вуліца
Дача вуліца 	Дача улица 	вуліца
Дачная вуліца 	Дачная улица 	вуліца
Дачны завулак 	Дачный переулок 	завулак
Дачны праезд 	Дачный проезд 	праезд
Дворышчы вуліца 	Дворищи улица 	вуліца
Дзвінская вуліца 	Двинская улица 	вуліца
Дзекабрыстаў вуліца 	Декабристов улица 	вуліца
Дзімітрава вуліца 	Димитрова улица 	вуліца
Дзісенская вуліца 	Дисенская улица 	вуліца
Дзіцячы 1-ы завулак 	Детский 1-й переулок 	завулак
Дзіцячы 2-і завулак 	Детский 2-й переулок 	завулак
Дзіцячы 3-і завулак 	Детский 3-й переулок 	завулак
Дзяжнёва вуліца 	Дежнёва улица 	вуліца
Дзям’яна Беднага вуліца 	Демьяна Бедного улица 	вуліца
Дзянісаўская вуліца 	Денисовская улица 	вуліца
Дзянісаўскі завулак 	Денисовский переулок 	завулак
Дзяржынскага праспект 	Дзержинского проспект 	праспект
Дняпроўская вуліца 	Днепровская улица 	вуліца
Дняпроўскі праезд 	Днепровский проезд 	праезд
Докшыцкая вуліца 	Докшицкая улица 	вуліца
Дражня вуліца 	Дражня улица 	вуліца
Дразда вуліца 	Дрозда улица 	вуліца
Дразды праезд 	Дрозды проезд 	праезд
Дружбы вуліца 	Дружбы улица 	вуліца
Друйская вуліца 	Друйская улица 	вуліца
Дубаўлянскі завулак 	Дубовлянский переулок 	завулак
Дубравінская вуліца 	Дубравинская улица 	вуліца
Дубравінскі завулак 	Дубравинский переулок 	завулак
Дукорская вуліца 	Дукорская улица 	вуліца
Дуніна-Марцінкевіча вуліца 	Дунина-Марцинкевича улица 	вуліца
Ежы Гедройца вуліца 	Ежи Гедройца улица 	вуліца
Ельніцкая вуліца 	Ельницкая улица 	вуліца
Ельскіх вуліца 	Ельских улица 	вуліца
Енісейскі 1-ы завулак 	Енисейский 1-й переулок 	завулак
Енісейскі 2-і завулак 	Енисейский 2-й переулок 	завулак
Енісейскі праезд 	Енисейский проезд 	праезд
Ермака вуліца 	Ермака улица 	вуліца
Ермака завулак 	Ермака переулок 	завулак
Еўфрасінні Полацкай вуліца 	Евфросиньи Полоцкой улица 	вуліца
Ёдкаўская вуліца 	Иодковская улица 	вуліца
Ждановіцкая вуліца 	Ждановичская улица 	вуліца
Жлобінская вуліца 	Жлобинская улица 	вуліца
Жудро вуліца 	Жудро улица 	вуліца
Жукава праспект 	Жукова проспект 	праспект
Жукоўскага 1-ы завулак 	Жуковского 1-й переулок 	завулак
Жукоўскага 2-і завулак 	Жуковского 2-й переулок 	завулак
Жукоўскага вуліца 	Жуковского улица 	вуліца
Жукоўскага праезд 	Жуковского проезд 	праезд
Жылуновіча вуліца 	Жилуновича улица 	вуліца
Завадская вуліца 	Заводская улица 	вуліца
Загарадны 1-ы завулак 	Загородный 1-й переулок 	завулак
Загарадны 2-і завулак 	Загородный 2-й переулок 	завулак
Загарадны 3-і завулак 	Загородный 3-й переулок 	завулак
Загарадны 4-ы завулак 	Загородный 4-й переулок 	завулак
Залатая вуліца 	Золотая улица 	вуліца
Залатая Горка вуліца 	Золотая Горка улица 	вуліца
Залаты завулак 	Золотой переулок 	завулак
Замкавая вуліца 	Замковая улица 	вуліца
Запарожская вуліца 	Запорожская улица 	вуліца
Запарожская плошча 	Запорожская площадь 	плошча
Запарожскі 1-ы завулак 	Запорожский 1-й переулок 	завулак
Запарожскі 3-і завулак 	Запорожский 3-й переулок 	завулак
Запрудная вуліца 	Запрудная улица 	вуліца
Зарачанскі завулак 	Заречанский переулок 	завулак
Зарэчная вуліца 	Заречная улица 	вуліца
Зарэчны 1-ы завулак 	Заречный 1-й переулок 	завулак
Зарэчны 2-і завулак 	Заречный 2-й переулок 	завулак
Зарэчны 3-і завулак 	Заречный 3-й переулок 	завулак
Зарэчны тупік 	Заречный тупик 	тупік
Заслаўская вуліца 	Заславская улица 	вуліца
Заслонава вуліца 	Заслонова улица 	вуліца
Заснавальнікаў вуліца 	Основателей улица 	вуліца
Захарава вуліца 	Захарова улица 	вуліца
Заходняя вуліца 	Западная улица 	вуліца
Зацань вуліца 	Зацень улица 	вуліца
Зацішша вуліца 	Затишье улица 	вуліца
Землямерная 1-я вуліца 	Землемерная 1-я улица 	вуліца
Землямерная 2-я вуліца 	Землемерная 2-я улица 	вуліца
Землямерны завулак 	Землемерный переулок 	завулак
Земляробчая вуліца 	Земледельческая улица 	вуліца
Земляробчы 1-ы завулак 	Земледельческий 1-й переулок 	завулак
Земляробчы 3-і завулак 	Земледельческий 3-й переулок 	завулак
Зенітны завулак 	Зенитный переулок 	завулак
Зімні 1-ы завулак 	Зимний 1-й переулок 	завулак
Зімні 2-і завулак 	Зимний 2-й переулок 	завулак
Зімняя вуліца 	Зимняя улица 	вуліца
Змітрака Бядулі вуліца 	Змитрока Бядули улица 	вуліца
Змітрака Бядулі плошча 	Змитрока Бядули площадь 	плошча
Зоі Касмадзям’янскай вуліца 	Зои Космодемьянской улица 	вуліца
Зорная вуліца 	Звёздная улица 	вуліца
Зубачова 1-ы завулак 	Зубачёва 1-й переулок 	завулак
Зубачова 2-і завулак 	Зубачёва 2-й переулок 	завулак
Зубачова 3-і завулак 	Зубачёва 3-й переулок 	завулак
Зубачова вуліца 	Зубачёва улица 	вуліца
Зыбіцкая вуліца 	Зыбицкая улица 	вуліца
Зялёналужская вуліца 	Зелёнолугская улица 	вуліца
Івана Навуменкі вуліца 	Ивана Науменко улица 	вуліца
Івана Хруцкага вуліца 	Ивана Хруцкого улица 	вуліца
Івана Шамякіна вуліца 	Ивана Шамякина улица 	вуліца
Іванаўская вуліца 	Ивановская улица 	вуліца
Івянецкая вуліца 	Ивенецкая улица 	вуліца
Ігара Лучанка вуліца 	Игоря Лученка улица 	вуліца
Ігната Буйніцкага вуліца 	Игната Буйницкого улица 	вуліца
Ігната Буйніцкага завулак 	Игната Буйницкого переулок 	завулак
Ігната Дамейкі вуліца 	Игната Домейко улица 	вуліца
Ігнаценкі вуліца 	Игнатенко улица 	вуліца
Ігуменскі тракт 	Игуменский тракт 	тракт
Іерусалімская вуліца 	Иерусалимская улица 	вуліца
Ізмайлаўская вуліца 	Измайловская улица 	вуліца
Ізмайлаўскі 1-ы завулак 	Измайловский 1-й переулок 	завулак
Ізмайлаўскі 2-і завулак 	Измайловский 2-й переулок 	завулак
Ізмайлаўскі 3-і завулак 	Измайловский 3-й переулок 	завулак
Ізмайлаўскі 4-ы завулак 	Измайловский 4-й переулок 	завулак
Ізмайлаўскі праезд 	Измайловский проезд 	праезд
Ізумрудны завулак 	Изумрудный переулок 	завулак
Ілімская вуліца 	Илимская улица 	вуліца
Ільі Капіевіча вуліца 	Ильи Копиевича улица 	вуліца
Ільменская вуліца 	Ильменская улица 	вуліца
Ільянская вуліца 	Ильянская улица 	вуліца
Індустрыяльная вуліца 	Индустриальная улица 	вуліца
Інжынерная вуліца 	Инженерная улица 	вуліца
Інжынерны завулак 	Инженерный переулок 	завулак
Інструментальны завулак 	Инструментальный переулок 	завулак
Інтэрнацыянальная вуліца 	Интернациональная улица 	вуліца
Іосіфа Гашкевіча вуліца 	Иосифа Гошкевича улица 	вуліца
Іосіфа Жыновіча вуліца 	Иосифа Жиновича улица 	вуліца
Іркуцкая вуліца 	Иркутская улица 	вуліца
Іркуцкі завулак 	Иркутский переулок 	завулак
Ірынаўская вуліца 	Ириновская улица 	вуліца
Ірынаўскі завулак 	Ириновский переулок 	завулак
Іскаліева вуліца 	Искалиева улица 	вуліца
Кааператыўны завулак 	Кооперативный переулок 	завулак
Кабушкіна вуліца 	Кабушкина улица 	вуліца
Кабушкіна завулак 	Кабушкина переулок 	завулак
Кавалёва вуліца 	Ковалёва улица 	вуліца
Кавальская вуліца 	Кузнечная улица 	вуліца
Казарменны завулак 	Казарменный переулок 	завулак
Казіміраўская вуліца 	Казимировская улица 	вуліца
Казінца вуліца 	Казинца улица 	вуліца
Казінца плошча 	Казинца площадь 	плошча
Казлова вуліца 	Козлова улица 	вуліца
Казлова завулак 	Козлова переулок 	завулак
Калгасная вуліца 	Колхозная улица 	вуліца
Калектарная вуліца 	Коллекторная улица 	вуліца
Калектыўны завулак 	Коллективный переулок 	завулак
Калектыўны праезд 	Коллективный проезд 	праезд
Калеснікава вуліца 	Колесникова улица 	вуліца
Калеснікава завулак 	Колесникова переулок 	завулак
Калініна вуліца 	Калинина улица 	вуліца
Калініна завулак 	Калинина переулок 	завулак
Калініна плошча 	Калинина площадь 	плошча
Калінінградскі завулак 	Калининградский переулок 	завулак
Каліноўскага вуліца 	Калиновского улица 	вуліца
Кальварыйская вуліца 	Кальварийская улица 	вуліца
Кальварыйскі праезд 	Кальварийский проезд 	праезд
Кальцавая 1-я вуліца 	Кольцевая 1-я улица 	вуліца
Кальцавая 2-я вуліца 	Кольцевая 2-я улица 	вуліца
Кальцавы 1-ы праезд 	Кольцевой 1-й проезд 	праезд
Кальцавы 2-і праезд 	Кольцевой 2-й проезд 	праезд
Кальцова 1-ы завулак 	Кольцова 1-й переулок 	завулак
Кальцова 2-і завулак 	Кольцова 2-й переулок 	завулак
Кальцова 3-і завулак 	Кольцова 3-й переулок 	завулак
Кальцова 4-ы завулак 	Кольцова 4-й переулок 	завулак
Кальцова вуліца 	Кольцова улица 	вуліца
Кальцова праезд 	Кольцова проезд 	праезд
Калядная вуліца 	Колядная улица 	вуліца
Камайская вуліца 	Камайская улица 	вуліца
Камароўскае кальцо 	Комаровское кольцо 	
Каменнагорская вуліца 	Каменногорская улица 	вуліца
Камсамольская вуліца 	Комсомольская улица 	вуліца
Камуністычная вуліца 	Коммунистическая улица 	вуліца
Канатны завулак 	Канатный переулок 	завулак
Кандрата Крапівы вуліца 	Кондрата Крапивы улица 	вуліца
Канстанцыі Буйло вуліца 	Констанции Буйло улица 	вуліца
Капыльская вуліца 	Копыльская улица 	вуліца
Капыльскі 1-ы завулак 	Копыльский 1-й переулок 	завулак
Капыльскі тупік 	Копыльский тупик 	тупік
Караленкі вуліца 	Короленко улица 	вуліца
Каралінская вуліца 	Каролинская улица 	вуліца
Каралінскі праезд 	Каролинский проезд 	праезд
Караля вуліца 	Короля улица 	вуліца
Караткевіча вуліца 	Короткевича улица 	вуліца
Карбышава вуліца 	Карбышева улица 	вуліца
Карвата вуліца 	Карвата улица 	вуліца
Каржа вуліца 	Коржа улица 	вуліца
Каржанеўскага вуліца 	Корженевского улица 	вуліца
Каржанеўскага завулак 	Корженевского переулок 	завулак
Карзюкі вуліца 	Корзюки улица 	вуліца
Карла Лібкнехта вуліца 	Карла Либкнехта улица 	вуліца
Карла Маркса вуліца 	Карла Маркса улица 	вуліца
Кароткі 1-ы завулак 	Короткий 1-й переулок 	завулак
Кароткі 2-і завулак 	Короткий 2-й переулок 	завулак
Кароткі 3-і завулак 	Короткий 3-й переулок 	завулак
Карпава вуліца 	Карпова улица 	вуліца
Каруся Каганца вуліца 	Каруся Каганца улица 	вуліца
Карыцкага вуліца 	Корицкого улица 	вуліца
Касманаўтаў вуліца 	Космонавтов улица 	вуліца
Кастрычніцкая вуліца 	Октябрьская улица 	вуліца
Кастрычніцкая плошча 	Октябрьская площадь 	плошча
Катоўскага вуліца 	Котовского улица 	вуліца
Катоўскага праезд 	Котовского проезд 	праезд
Кахоўская вуліца 	Каховская улица 	вуліца
Кахоўскі завулак 	Каховский переулок 	завулак
Качынская вуліца 	Качинская улица 	вуліца
Каштанавая вуліца 	Каштановая улица 	вуліца
Кедышкі вуліца 	Кедышко улица 	вуліца
Кіеўская вуліца 	Киевская улица 	вуліца
Кірава вуліца 	Кирова улица 	вуліца
Кірыла і Мяфодзія вуліца 	Кирилла и Мефодия улица 	вуліца
Кірыла Тураўскага вуліца 	Кирилла Туровского улица 	вуліца
Кірэева вуліца 	Киреева улица 	вуліца
Кірэенкі вуліца 	Киреенко улица 	вуліца
Кісялёва вуліца 	Киселёва улица 	вуліца
Клары Цэткін вуліца 	Клары Цеткин улица 	вуліца
Клецкая вуліца 	Клецкая улица 	вуліца
Клецкі праезд 	Клецкий проезд 	праезд
Клубны праезд 	Клубный проезд 	праезд
Клумава вуліца 	Клумова улица 	вуліца
Клумава завулак 	Клумова переулок 	завулак
Ключавая вуліца 	Ключевая улица 	вуліца
Кнорына вуліца 	Кнорина улица 	вуліца
Княгінінская вуліца 	Княгининская улица 	вуліца
Княгінінскі завулак 	Княгининский переулок 	завулак
Кобрынская вуліца 	Кобринская улица 	вуліца
Козыраўская вуліца 	Козыревская улица 	вуліца
Козьма-Дзям’янаўскі спуск 	Козьмо-Демьяновский спуск 	спуск
Корш-Сабліна вуліца 	Корш-Саблина улица 	вуліца
Крайняя вуліца 	Крайняя улица 	вуліца
Крамскога вуліца 	Крамского улица 	вуліца
Крапоткіна вуліца 	Кропоткина улица 	вуліца
Круглы завулак 	Круглый переулок 	завулак
Крупецкая вуліца 	Крупецкая улица 	вуліца
Крупскай вуліца 	Крупской улица 	вуліца
Крупцы вуліца 	Крупцы улица 	вуліца
Крывіцкая вуліца 	Кривичская улица 	вуліца
Крывіцкі 1-ы завулак 	Кривичский 1-й переулок 	завулак
Крывіцкі 2-і завулак 	Кривичский 2-й переулок 	завулак
Крыжоўская вуліца 	Крыжовская улица 	вуліца
Крыловіча 1-ы завулак 	Крыловича 1-й переулок 	завулак
Крыловіча 2-і завулак 	Крыловича 2-й переулок 	завулак
Крыловіча вуліца 	Крыловича улица 	вуліца
Крынічная вуліца 	Родниковая улица 	вуліца
Кубанская вуліца 	Кубанская улица 	вуліца
Кузьмы Мініна вуліца 	Кузьмы Минина улица 	вуліца
Кузьмы Мініна завулак 	Кузьмы Минина переулок 	завулак
Кузьмы Чорнага вуліца 	Кузьмы Чорного улица 	вуліца
Кузьмы Чорнага завулак 	Кузьмы Чорного переулок 	завулак
Куйбышава вуліца 	Куйбышева улица 	вуліца
Кулібіна вуліца 	Кулибина улица 	вуліца
Кульман вуліца 	Кульман улица 	вуліца
Куляшова вуліца 	Кулешова улица 	вуліца
Кунцаўшчына вуліца 	Кунцевщина улица 	вуліца
Купрыянава вуліца 	Куприянова улица 	вуліца
Курганная вуліца 	Курганная улица 	вуліца
Курсанта Гвішыані вуліца 	Курсанта Гвишиани улица 	вуліца
Кутузава вуліца 	Кутузова улица 	вуліца
Кэчаўскі завулак 	Кэчевский переулок 	завулак
Лабанка вуліца 	Лобанка улица 	вуліца
Лагойскі тракт 	Логойский тракт 	тракт
Лазарава вуліца 	Лазарева улица 	вуліца
Лазо вуліца 	Лазо улица 	вуліца
Лазо завулак 	Лазо переулок 	завулак
Ламаносава вуліца 	Ломоносова улица 	вуліца
Ламаносава завулак 	Ломоносова переулок 	завулак
Ландэра вуліца 	Ландера улица 	вуліца
Лапаровіцкая вуліца 	Лапаровичская улица 	вуліца
Ларысы Александроўскай вуліца 	Ларисы Александровской улица 	вуліца
Леаніда Бяды вуліца 	Леонида Беды улица 	вуліца
Леаніда Левіна вуліца 	Леонида Левина улица 	вуліца
Лейтэнанта Кіжаватава вуліца 	Лейтенанта Кижеватова улица 	вуліца
Леніна вуліца 	Ленина улица 	вуліца
Ленінградская вуліца 	Ленинградская улица 	вуліца
Лепельская вуліца 	Лепельская улица 	вуліца
Лермантава вуліца 	Лермонтова улица 	вуліца
Лесапаркавая вуліца 	Лесопарковая улица 	вуліца
Лесі Украінкі вуліца 	Леси Украинки улица 	вуліца
Летні 1-ы завулак 	Летний 1-й переулок 	завулак
Летні 2-і завулак 	Летний 2-й переулок 	завулак
Летняя вуліца 	Летняя улица 	вуліца
Лібава-Роменская вуліца 	Либаво-Роменская улица 	вуліца
Лівенцава вуліца 	Ливенцева улица 	вуліца
Лідская вуліца 	Лидская улица 	вуліца
Лізы Чайкінай вуліца 	Лизы Чайкиной улица 	вуліца
Лілі Карастаянавай вуліца 	Лили Карастояновой улица 	вуліца
Лінейны завулак 	Линейный переулок 	завулак
Ліпавая вуліца 	Липовая улица 	вуліца
Ліпкаўская вуліца 	Липковская улица 	вуліца
Ліпкаўскі завулак 	Липковский переулок 	завулак
Ліпкаўскі праезд 	Липковский проезд 	праезд
Літаратурная вуліца 	Литературная улица 	вуліца
Літаратурны завулак 	Литературный переулок 	завулак
Ложынская вуліца 	Ложинская улица 	вуліца
Лошыца 1-я вуліца 	Лошица 1-я улица 	вуліца
Лошыца 2-я вуліца 	Лошица 2-я улица 	вуліца
Лошыцкая вуліца 	Лошицкая улица 	вуліца
Лошыцкі завулак 	Лошицкий переулок 	завулак
Лошыцкі праезд 	Лошицкий проезд 	праезд
Лугавая вуліца 	Луговая улица 	вуліца
Лугавы завулак 	Луговой переулок 	завулак
Лук’яновіча вуліца 	Лукьяновича улица 	вуліца
Лучайская вуліца 	Лучайская улица 	вуліца
Льва Сапегі вуліца 	Льва Сапеги улица 	вуліца
Льва Талстога вуліца 	Льва Толстого улица 	вуліца
Льва Талстога завулак 	Льва Толстого переулок 	завулак
Любанская вуліца 	Любанская улица 	вуліца
Любімава праспект 	Любимова проспект 	праспект
Люцынская вуліца 	Люцинская улица 	вуліца
Ляўкова вуліца 	Левкова улица 	вуліца
Ляшчынскага вуліца 	Лещинского улица 	вуліца
Магілёўская вуліца 	Могилёвская улица 	вуліца
Магілёўская шаша 	Могилёвское шоссе 	шаша
Магнітная вуліца 	Магнитная улица 	вуліца
Магнітны завулак 	Магнитный переулок 	завулак
Мажайскага 1-ы завулак 	Можайского 1-й переулок 	завулак
Мажайскага 2-і завулак 	Можайского 2-й переулок 	завулак
Мажайскага 3-і завулак 	Можайского 3-й переулок 	завулак
Мажайскага вуліца 	Можайского улица 	вуліца
Мазурава вуліца 	Мазурова улица 	вуліца
Мазырская вуліца 	Мозырская улица 	вуліца
Мазырскі завулак 	Мозырский переулок 	завулак
Мазырскі праезд 	Мозырский проезд 	праезд
Майкава завулак 	Майкова переулок 	завулак
Макаёнка вуліца 	Макаёнка улица 	вуліца
Макаёнка завулак 	Макаёнка переулок 	завулак
Макаранкі вуліца 	Макаренко улица 	вуліца
Максіма Багдановіча вуліца 	Максима Богдановича улица 	вуліца
Максіма Багдановіча завулак 	Максима Богдановича переулок 	завулак
Максіма Гарэцкага вуліца 	Максима Горецкого улица 	вуліца
Максіма Танка вуліца 	Максима Танка улица 	вуліца
Маладзечанская вуліца 	Молодечненская улица 	вуліца
Малаковіч вуліца 	Малакович улица 	вуліца
Маласерабранская вуліца 	Малосеребрянская улица 	вуліца
Малафееўская вуліца 	Малофеевская улица 	вуліца
Малая вуліца 	Малая улица 	вуліца
Малініна вуліца 	Малинина улица 	вуліца
Малое Сціклева вуліца 	Малое Стиклево улица 	вуліца
Малочны завулак 	Молочный переулок 	завулак
Малы 2-і завулак 	Малый 2-й переулок 	завулак
Малы завулак 	Малый переулок 	завулак
Малы Трасцянец вуліца 	Малый Тростенец улица 	вуліца
Малы Трасцянец завулак 	Малый Тростенец переулок 	завулак
Маляўкі вуліца 	Малявки улица 	вуліца
Маневіча вуліца 	Маневича улица 	вуліца
Мантажнікаў 1-ы завулак 	Монтажников 1-й переулок 	завулак
Мантажнікаў 2-і завулак 	Монтажников 2-й переулок 	завулак
Мантажнікаў 3-і завулак 	Монтажников 3-й переулок 	завулак
Мантажнікаў 4-ы завулак 	Монтажников 4-й переулок 	завулак
Мантажнікаў вуліца 	Монтажников улица 	вуліца
Мар’еўская вуліца 	Марьевская улица 	вуліца
Марата вуліца 	Марата улица 	вуліца
Маргелава вуліца 	Маргелова улица 	вуліца
Марусінская вуліца 	Марусинская улица 	вуліца
Марусінскі 1-ы завулак 	Марусинский 1-й переулок 	завулак
Марусінскі 2-і завулак 	Марусинский 2-й переулок 	завулак
Маршала Лосіка вуліца 	Маршала Лосика улица 	вуліца
Масквіна вуліца 	Москвина улица 	вуліца
Масквіна завулак 	Москвина переулок 	завулак
Маскоўская вуліца 	Московская улица 	вуліца
Масюкоўшчына вуліца 	Масюковщина улица 	вуліца
Масюкоўшчына завулак 	Масюковщина переулок 	завулак
Масюкоўшчына праезд 	Масюковщина проезд 	праезд
Матросава вуліца 	Матросова улица 	вуліца
Матусевіча вуліца 	Матусевича улица 	вуліца
Мацвееўская вуліца 	Матвеевская улица 	вуліца
Мацвееўскі завулак 	Матвеевский переулок 	завулак
Мачульскага вуліца 	Мачульского улица 	вуліца
Машынабудаўнікоў вуліца 	Машиностроителей улица 	вуліца
Машыністаў вуліца 	Машинистов улица 	вуліца
Машыністаў завулак 	Машинистов переулок 	завулак
Машэрава праспект 	Машерова проспект 	праспект
Маякоўскага вуліца 	Маяковского улица 	вуліца
Маякоўскага завулак 	Маяковского переулок 	завулак
Мележа вуліца 	Мележа улица 	вуліца
Меліярацыйная вуліца 	Мелиоративная улица 	вуліца
Меліярацыйны завулак 	Мелиоративный переулок 	завулак
Мельнікайтэ вуліца 	Мельникайте улица 	вуліца
Мендзялеева 1-ы завулак 	Менделеева 1-й переулок 	завулак
Мендзялеева вуліца 	Менделеева улица 	вуліца
Металістаў праезд 	Металлистов проезд 	праезд
Мікалаеўская вуліца 	Миколаевская улица 	вуліца
Мікуліча вуліца 	Микулича улица 	вуліца
Мінская вуліца 	Минская улица 	вуліца
Мінская кальцавая аўтамабільная дарога 	Минская кольцевая автомобильная дорога улица 	вуліца
Мірашнічэнкі вуліца 	Мирошниченко улица 	вуліца
Мірная вуліца 	Мирная улица 	вуліца
Міру праспект 	Мира проспект 	праспект
Міхаіла Мармулёва вуліца 	Михаила Мормулёва улица 	вуліца
Міхаіла Пташука вуліца 	Михаила Пташука улица 	вуліца
Міхаіла Савіцкага вуліца 	Михаила Савицкого улица 	вуліца
Міхайлава вуліца 	Михайлова улица 	вуліца
Міхайлаўскі завулак 	Михайловский переулок 	завулак
Міхалова 1-ы завулак 	Михалово 1-й переулок 	завулак
Міхалова 2-і завулак 	Михалово 2-й переулок 	завулак
Міхалова 3-і завулак 	Михалово 3-й переулок 	завулак
Міхалова 4-ы завулак 	Михалово 4-й переулок 	завулак
Міхалова вуліца 	Михалово улица 	вуліца
Міхалоўская вуліца 	Михаловская улица 	вуліца
Міхася Лынькова вуліца 	Михася Лынькова улица 	вуліца
Міхася Чарота вуліца 	Михася Чарота улица 	вуліца
Мічурына вуліца 	Мичурина улица 	вуліца
Млынавы завулак 	Мельничный переулок 	завулак
Музычны завулак 	Музыкальный переулок 	завулак
Мулявіна бульвар 	Мулявина бульвар 	бульвар
Мядзвежына вуліца 	Медвежино улица 	вуліца
Мядзвежына завулак 	Медвежино переулок 	завулак
Мядзельская вуліца 	Мядельская улица 	вуліца
Мяржынскага вуліца 	Мержинского улица 	вуліца
Мяснікова вуліца 	Мясникова улица 	вуліца
Мяснікова плошча 	Мясникова площадь 	плошча
Мястраўская вуліца 	Мястровская улица 	вуліца
Набярэжная вуліца 	Набережная улица 	вуліца
Нававіленская вуліца 	Нововиленская улица 	вуліца
Нававіленскі завулак 	Нововиленский переулок 	завулак
Навасельская вуліца 	Новосельская улица 	вуліца
Наватарская вуліца 	Новаторская улица 	вуліца
Наватарскі завулак 	Новаторский переулок 	завулак
Наватарскі праезд 	Новаторский проезд 	праезд
Наваўфімская вуліца 	Новоуфимская улица 	вуліца
Навінкаўская вуліца 	Новинковская улица 	вуліца
Навуковая вуліца 	Навуковая улица 	вуліца
Нагіна вуліца 	Ногина улица 	вуліца
Нагорная вуліца 	Нагорная улица 	вуліца
Нагорны завулак 	Нагорный переулок 	завулак
Надзеждзінская вуліца 	Надеждинская улица 	вуліца
Налібоцкая вуліца 	Налибокская улица 	вуліца
Напалеона Орды вуліца 	Наполеона Орды улица 	вуліца
Нарачанская вуліца 	Нарочанская улица 	вуліца
Народная вуліца 	Народная улица 	вуліца
Натуралістаў вуліца 	Натуралистов улица 	вуліца
Наўгародская вуліца 	Новгородская улица 	вуліца
Наўгародскі завулак 	Новгородский переулок 	завулак
Нафтавая вуліца 	Нефтяная улица 	вуліца
Нафтавы завулак 	Нефтяной переулок 	завулак
Нахіленая вуліца 	Наклонная улица 	вуліца
Нахілены 1-ы завулак 	Наклонный 1-й переулок 	завулак
Нахілены 2-і завулак 	Наклонный 2-й переулок 	завулак
Нахімава вуліца 	Нахимова улица 	вуліца
Нахімава завулак 	Нахимова переулок 	завулак
Незалежнасці плошча 	Независимости площадь 	плошча
Незалежнасці праспект 	Независимости проспект 	праспект
Некрашэвіча вуліца 	Некрашевича улица 	вуліца
Несцерава 1-ы завулак 	Нестерова 1-й переулок 	завулак
Несцерава 2-і завулак 	Нестерова 2-й переулок 	завулак
Несцерава вуліца 	Нестерова улица 	вуліца
Неўскі завулак 	Невский переулок 	завулак
Нёманская вуліца 	Нёманская улица 	вуліца
Нікіфарава вуліца 	Никифорова улица 	вуліца
Нікіціна 1-ы завулак 	Никитина 1-й переулок 	завулак
Нікіціна 2-і завулак 	Никитина 2-й переулок 	завулак
Нікіціна вуліца 	Никитина улица 	вуліца
Новая вуліца 	Новая улица 	вуліца
Няжданавай вуліца 	Неждановой улица 	вуліца
Няжданавай завулак 	Неждановой переулок 	завулак
Някрасава вуліца 	Некрасова улица 	вуліца
Някрасава завулак 	Некрасова переулок 	завулак
Няміга вуліца 	Немига улица 	вуліца
Нясвіжская вуліца 	Несвижская улица 	вуліца
Олешава вуліца 	Олешева улица 	вуліца
Падгорная вуліца 	Подгорная улица 	вуліца
Падлесная вуліца 	Подлесная улица 	вуліца
Падольская вуліца 	Подольская улица 	вуліца
Падольскі 1-ы завулак 	Подольский 1-й переулок 	завулак
Падольскі 2-і завулак 	Подольский 2-й переулок 	завулак
Падольскі 3-і завулак 	Подольский 3-й переулок 	завулак
Падольскі 4-ы завулак 	Подольский 4-й переулок 	завулак
Падшыпнікавы 1-ы завулак 	Подшипниковый 1-й переулок 	завулак
Падшыпнікавы 2-і завулак 	Подшипниковый 2-й переулок 	завулак
Падшыпнікавы праезд 	Подшипниковый проезд 	праезд
Пажарная вуліца 	Пожарная улица 	вуліца
Пажарскага вуліца 	Пожарского улица 	вуліца
Пакроўская вуліца 	Покровская улица 	вуліца
Пакроўскі завулак 	Покровский переулок 	завулак
Палеская вуліца 	Полесская улица 	вуліца
Палзунова завулак 	Ползунова переулок 	завулак
Паліграфічная вуліца 	Полиграфическая улица 	вуліца
Паліграфічны 1-ы завулак 	Полиграфический 1-й переулок 	завулак
Паліграфічны 2-і завулак 	Полиграфический 2-й переулок 	завулак
Паліграфічны 3-і завулак 	Полиграфический 3-й переулок 	завулак
Паліграфічны 4-ы завулак 	Полиграфический 4-й переулок 	завулак
Палтаўская вуліца 	Полтавская улица 	вуліца
Палявая вуліца 	Полевая улица 	вуліца
Палявы завулак 	Полевой переулок 	завулак
Палярная вуліца 	Полярная улица 	вуліца
Панамарова вуліца 	Пономарёва улица 	вуліца
Панамарэнкі вуліца 	Пономаренко улица 	вуліца
Панфілава вуліца 	Панфилова улица 	вуліца
Папаніна вуліца 	Папанина улица 	вуліца
Папова вуліца 	Попова улица 	вуліца
Папярнянская вуліца 	Папернянская улица 	вуліца
Папярнянскі завулак 	Папернянский переулок 	завулак
Паравозны завулак 	Паровозный переулок 	завулак
Парашутная вуліца 	Парашютная улица 	вуліца
Паркавая вуліца 	Парковая улица 	вуліца
Парніковая вуліца 	Парниковая улица 	вуліца
Парніковы 3-і завулак 	Парниковый 3-й переулок 	завулак
Партызанская вуліца 	Партизанская улица 	вуліца
Партызанскі праспект 	Партизанский проспект 	праспект
Пархоменкі вуліца 	Пархоменко улица 	вуліца
Парыжскай Камуны плошча 	Парижской Коммуны площадь 	плошча
Пастаўская вуліца 	Поставская улица 	вуліца
Пасялковая 1-я вуліца 	Поселковая 1-я улица 	вуліца
Пасялковая 2-я вуліца 	Поселковая 2-я улица 	вуліца
Пасялковы 2-і завулак 	Поселковый 2-й переулок 	завулак
Пасялковы 3-і завулак 	Поселковый 3-й переулок 	завулак
Пасялковы завулак 	Поселковый переулок 	завулак
Паўднёвая вуліца 	Южная улица 	вуліца
Паўднёвы 1-ы завулак 	Южный 1-й переулок 	завулак
Паўднёвы завулак 	Южный переулок 	завулак
Паўла Шпілеўскага вуліца 	Павла Шпилевского улица 	вуліца
Паўлава вуліца 	Павлова улица 	вуліца
Паўлава завулак 	Павлова переулок 	завулак
Паўліны Мядзёлкі вуліца 	Павлины Меделки улица 	вуліца
Паўлоўскага вуліца 	Павловского улица 	вуліца
Паўлюка Труса вуліца 	Павлюка Труса улица 	вуліца
Паўночны завулак 	Северный переулок 	завулак
Паштовая вуліца 	Почтовая улица 	вуліца
Пензенская вуліца 	Пензенская улица 	вуліца
Перадавая вуліца 	Передовая улица 	вуліца
Перадавы завулак 	Передовой переулок 	завулак
Перамогі плошча 	Победы площадь 	плошча
Пераможцаў праспект 	Победителей проспект 	праспект
Пераходная вуліца 	Переходная улица 	вуліца
Пераходны 1-ы завулак 	Переходной 1-й переулок 	завулак
Пераходны 2-і завулак 	Переходной 2-й переулок 	завулак
Пермская вуліца 	Пермская улица 	вуліца
Пермскі завулак 	Пермский переулок 	завулак
Першамайская вуліца 	Первомайская улица 	вуліца
Петруся Броўкі вуліца 	Петруся Бровки улица 	вуліца
Пілоцкая вуліца 	Пилотская улица 	вуліца
Пільнінцкая вуліца 	Пильницкая улица 	вуліца
Пімена Панчанкі вуліца 	Пимена Панченко улица 	вуліца
Пінская вуліца 	Пинская улица 	вуліца
Пірагова 1-ы завулак 	Пирогова 1-й переулок 	завулак
Пірагова 2-і завулак 	Пирогова 2-й переулок 	завулак
Пірагова вуліца 	Пирогова улица 	вуліца
Піянерская вуліца 	Пионерская улица 	вуліца
Планёрная вуліца 	Планёрная улица 	вуліца
Платонава вуліца 	Платонова улица 	вуліца
Пляханава вуліца 	Плеханова улица 	вуліца
Полацкая вуліца 	Полоцкая улица 	вуліца
Полацкі завулак 	Полоцкий переулок 	завулак
Праграмістаў вуліца 	Программистов улица 	вуліца
Прагрэсіўная вуліца 	Прогрессивная улица 	вуліца
Прамая вуліца 	Прямая улица 	вуліца
Прамысловая вуліца 	Промышленная улица 	вуліца
Прамысловы завулак 	Промышленный переулок 	завулак
Прафсаюзная вуліца 	Профсоюзная улица 	вуліца
Прафсаюзны завулак 	Профсоюзный переулок 	завулак
Прафсаюзны праезд 	Профсоюзный проезд 	праезд
Працоўная вуліца 	Трудовая улица 	вуліца
Праязны завулак 	Проездной переулок 	завулак
Пржавальскага 2-я вуліца 	Пржевальского 2-я улица 	вуліца
Пржавальскага вуліца 	Пржевальского улица 	вуліца
Прушынскіх вуліца 	Прушинских улица 	вуліца
Прыазёрная вуліца 	Приозёрная улица 	вуліца
Прывабная вуліца 	Привабная улица 	вуліца
Прывакзальная плошча 	Привокзальная площадь 	плошча
Прыветлівая вуліца 	Приветливая улица 	вуліца
Прыгарадная вуліца 	Пригородная улица 	вуліца
Прыгожая вуліца 	Красивая улица 	вуліца
Прыгожы завулак 	Красивый переулок 	завулак
Прыдарожная вуліца 	Придорожная улица 	вуліца
Прылуцкая вуліца 	Прилукская улица 	вуліца
Прылуцкі 2-і завулак 	Прилукский 2-й переулок 	завулак
Прытыцкага вуліца 	Притыцкого улица 	вуліца
Пскоўская вуліца 	Псковская улица 	вуліца
Пугачоўская вуліца 	Пугачёвская улица 	вуліца
Пуліхава вуліца 	Пулихова улица 	вуліца
Пухавіцкая вуліца 	Пуховичская улица 	вуліца
Пуцейская вуліца 	Путейская улица 	вуліца
Пуцейскі завулак 	Путейский переулок 	завулак
Пуцеправодны 1-ы завулак 	Путепроводный 1-й переулок 	завулак
Пуцеправодны 2-і завулак 	Путепроводный 2-й переулок 	завулак
Пуцеправодны 3-і завулак 	Путепроводный 3-й переулок 	завулак
Пуцеправодны 4-ы завулак 	Путепроводный 4-й переулок 	завулак
Пуцеправодны 5-ы завулак 	Путепроводный 5-й переулок 	завулак
Пуцеправодны 6-ы завулак 	Путепроводный 6-й переулок 	завулак
Пуцеправодны 7-ы завулак 	Путепроводный 7-й переулок 	завулак
Пуцеправодны 8-ы завулак 	Путепроводный 8-й переулок 	завулак
Пуцілава вуліца 	Путилова улица 	вуліца
Пушкіна праспект 	Пушкина проспект 	праспект
Пясочная 2-я вуліца 	Песочная 2-я улица 	вуліца
Пятра Глебкі вуліца 	Петра Глебки улица 	вуліца
Пятра Мсціслаўца вуліца 	Петра Мстиславца улица 	вуліца
Пятра Румянцава вуліца 	Петра Румянцева улица 	вуліца
Пятра Сергіевіча вуліца 	Петра Сергиевича улица 	вуліца
Пятроўшчына вуліца 	Петровщина улица 	вуліца
Пятроўшчына завулак 	Петровщина переулок 	завулак
Рабінавая вуліца 	Рябиновая улица 	вуліца
Рабінніцкая вуліца 	Рябинницкая улица 	вуліца
Рабкараўская вуліца 	Рабкоровская улица 	вуліца
Рабочы завулак 	Рабочий переулок 	завулак
Рагачоўская вуліца 	Рогачёвская улица 	вуліца
Рагачоўскі завулак 	Рогачёвский переулок 	завулак
Рагачоўскі праезд 	Рогачёвский проезд 	праезд
Радашкоўская вуліца 	Радашковская улица 	вуліца
Радашкоўскі завулак 	Радашковский переулок 	завулак
Радзішчава вуліца 	Радищева улица 	вуліца
Радыяльная вуліца 	Радиальная улица 	вуліца
Радыятарная 1-я вуліца 	Радиаторная 1-я улица 	вуліца
Радыятарны 1-ы завулак 	Радиаторный 1-й переулок 	завулак
Радыятарны 2-і завулак 	Радиаторный 2-й переулок 	завулак
Радыятарны 3-і завулак 	Радиаторный 3-й переулок 	завулак
Радыятарны 4-ы завулак 	Радиаторный 4-й переулок 	завулак
Радыятарны 5-ы завулак 	Радиаторный 5-й переулок 	завулак
Разінская вуліца 	Разинская улица 	вуліца
Разінскі завулак 	Разинский переулок 	завулак
Ракасоўскага праспект 	Рокоссовского проспект 	праспект
Ракаўская вуліца 	Раковская улица 	вуліца
Раманаўская Слабада вуліца 	Романовская Слобода улица 	вуліца
Рамашкіна вуліца 	Ромашкина улица 	вуліца
Расонская вуліца 	Рассонская улица 	вуліца
Ратамская вуліца 	Ратомская улица 	вуліца
Ратамскі 1-ы завулак 	Ратомский 1-й переулок 	завулак
Ратамскі 2-і завулак 	Ратомский 2-й переулок 	завулак
Раўбіцкая вуліца 	Раубичская улица 	вуліца
Раўбіцкі завулак 	Раубичский переулок 	завулак
Рафіева вуліца 	Рафиева улица 	вуліца
Рачная вуліца 	Речная улица 	вуліца
Ржавецкая вуліца 	Ржавецкая улица 	вуліца
Ржавецкі завулак 	Ржавецкий переулок 	завулак
Розы Люксембург 2-і завулак 	Розы Люксембург 2-й переулок 	завулак
Розы Люксембург вуліца 	Розы Люксембург улица 	вуліца
Роменская вуліца 	Роменская улица 	вуліца
Ротмістрава вуліца 	Ротмистрова улица 	вуліца
Рудабельская вуліца 	Рудобельская улица 	вуліца
Русановіча вуліца 	Русановича улица 	вуліца
Русіянава вуліца 	Руссиянова улица 	вуліца
Рыбалкі вуліца 	Рыбалко улица 	вуліца
Рыгора Шырмы вуліца 	Григория Ширмы улица 	вуліца
Рыжская вуліца 	Рижская улица 	вуліца
Рыжскі 1-ы завулак 	Рижский 1-й переулок 	завулак
Рыжскі 2-і завулак 	Рижский 2-й переулок 	завулак
Рылеева вуліца 	Рылеева улица 	вуліца
Рэвалюцыйная вуліца 	Революционная улица 	вуліца
Рэпіна вуліца 	Репина улица 	вуліца
Рэспубліканская вуліца 	Республиканская улица 	вуліца
Савецкая вуліца 	Советская улица 	вуліца
Садовая вуліца 	Садовая улица 	вуліца
Сакалянскі завулак 	Соколянский переулок 	завулак
Саламяная вуліца 	Соломенная улица 	вуліца
Салаўіны завулак 	Соловьиный переулок 	завулак
Самарскі завулак 	Самарский переулок 	завулак
Сапёраў вуліца 	Сапёров улица 	вуліца
Сасновая вуліца 	Сосновая улица 	вуліца
Сасновы Бор вуліца 	Сосновый Бор улица 	вуліца
Сацыялістычная вуліца 	Социалистическая улица 	вуліца
Свабоды плошча 	Свободы площадь 	плошча
Светлая вуліца 	Светлая улица 	вуліца
Свірскі 1-ы завулак 	Свирский 1-й переулок 	завулак
Свірскі 2-і завулак 	Свирский 2-й переулок 	завулак
Свірскі 3-і завулак 	Свирский 3-й переулок 	завулак
Свірскі 4-ы завулак 	Свирский 4-й переулок 	завулак
Свіслацкая вуліца 	Свислочская улица 	вуліца
Свіслацкі завулак 	Свислочский переулок 	завулак
Свярдлова вуліца 	Свердлова улица 	вуліца
Севастопальская вуліца 	Севастопольская улица 	вуліца
Севастопальскі завулак 	Севастопольский переулок 	завулак
Сенніцкая вуліца 	Сенницкая улица 	вуліца
Сенніцкі праезд 	Сенницкий проезд 	праезд
Серабранская вуліца 	Серебрянская улица 	вуліца
Серабранскі завулак 	Серебрянский переулок 	завулак
Серафімовіча вуліца 	Серафимовича улица 	вуліца
Сечанава вуліца 	Сеченова улица 	вуліца
Сёмкаўская вуліца 	Сёмковская улица 	вуліца
Сёмкаўскі завулак 	Сёмковский переулок 	завулак
Сілікатны 1-ы завулак 	Силикатный 1-й переулок 	завулак
Сілікатны 2-і завулак 	Силикатный 2-й переулок 	завулак
Скалінская вуліца 	Скалинская улица 	вуліца
Скрыганава вуліца 	Скрыганова улица 	вуліца
Скрыпнікава вуліца 	Скрипникова улица 	вуліца
Слабадская вуліца 	Слободская улица 	вуліца
Слабадскі завулак 	Слободской переулок 	завулак
Слабадскі праезд 	Слободской проезд 	праезд
Славінскага вуліца 	Славинского улица 	вуліца
Славянская вуліца 	Славянская улица 	вуліца
Слаўны завулак 	Славный переулок 	завулак
Слонімская вуліца 	Слонимская улица 	вуліца
Слуцкай вуліца 	Слуцкой улица 	вуліца
Сляпнянскі 5-ы завулак 	Слепнянский 5-й переулок 	завулак
Слясарная вуліца 	Слесарная улица 	вуліца
Смаленская вуліца 	Смоленская улица 	вуліца
Смалячкова вуліца 	Смолячкова улица 	вуліца
Смілавіцкі тракт 	Смиловичский тракт 	тракт
Смірнова вуліца 	Смирнова улица 	вуліца
Сморгаўскі 1-ы завулак 	Сморговский 1-й переулок 	завулак
Сморгаўскі 2-і завулак 	Сморговский 2-й переулок 	завулак
Сморгаўскі 3-і завулак 	Сморговский 3-й переулок 	завулак
Сморгаўскі 4-ы завулак 	Сморговский 4-й переулок 	завулак
Сморгаўскі 5-ы завулак 	Сморговский 5-й переулок 	завулак
Сморгаўскі праезд 	Сморговский проезд 	праезд
Сморгаўскі тракт 	Сморговский тракт 	тракт
Снежны завулак 	Снежный переулок 	завулак
Собінава 2-і завулак 	Собинова 2-й переулок 	завулак
Собінава вуліца 	Собинова улица 	вуліца
Собінава завулак 	Собинова переулок 	завулак
Солтыса вуліца 	Солтыса улица 	вуліца
Солтыса завулак 	Солтыса переулок 	завулак
Сонечная вуліца 	Солнечная улица 	вуліца
Сонечны завулак 	Солнечный переулок 	завулак
Соф’і Кавалеўскай завулак 	Софьи Ковалевской переулок 	завулак
Спартыўны завулак 	Спортивный переулок 	завулак
Стадыённая вуліца 	Стадионная улица 	вуліца
Стайкаўская вуліца 	Стайковская улица 	вуліца
Сталетава вуліца 	Столетова улица 	вуліца
Сталетава завулак 	Столетова переулок 	завулак
Сталетава праезд 	Столетова проезд 	праезд
Сталічная вуліца 	Столичная улица 	вуліца
Сталічны завулак 	Столичный переулок 	завулак
Сталічны праезд 	Столичный проезд 	праезд
Станіслава Манюшкі вуліца 	Станислава Монюшко улица 	вуліца
Станіслава Манюшкі вуліца 	Станислава Монюшко улица 	вуліца
Станіслаўскага вуліца 	Станиславского улица 	вуліца
Станцыйны завулак 	Станционный переулок 	завулак
Старавіленская вуліца 	Старовиленская улица 	вуліца
Старавіленскі тракт 	Старовиленский тракт 	тракт
Старажоўская вуліца 	Сторожовская улица 	вуліца
Старатраецкая плошча 	Старотроицкая площадь 	плошча
Старобінская вуліца 	Старобинская улица 	вуліца
Старынаўская вуліца 	Стариновская улица 	вуліца
Стасава 1-ы завулак 	Стасова 1-й переулок 	завулак
Стасава 2-і завулак 	Стасова 2-й переулок 	завулак
Стасава 3-і завулак 	Стасова 3-й переулок 	завулак
Стасава вуліца 	Стасова улица 	вуліца
Стаўбцоўская вуліца 	Столбцовская улица 	вуліца
Стаханаўская вуліца 	Стахановская улица 	вуліца
Стаханаўскі завулак 	Стахановский переулок 	завулак
Стралковая вуліца 	Стрелковая улица 	вуліца
Стругаўская вуліца 	Струговская улица 	вуліца
Студэнцкая вуліца 	Студенческая улица 	вуліца
Студэнцкі завулак 	Студенческий переулок 	завулак
Стэпавы завулак 	Степной переулок 	завулак
Стэфанаўская вуліца 	Стефановская улица 	вуліца
Стэфаніі Станюты вуліца 	Стефании Станюты улица 	вуліца
Суворава вуліца 	Суворова улица 	вуліца
Сувязістаў вуліца 	Связистов улица 	вуліца
Судмаліса вуліца 	Судмалиса улица 	вуліца
Суражская вуліца 	Суражская улица 	вуліца
Сурганава вуліца 	Сурганова улица 	вуліца
Сурыкава вуліца 	Сурикова улица 	вуліца
Сурыкава завулак 	Сурикова переулок 	завулак
Сурыкава праезд 	Сурикова проезд 	праезд
Сустрэчная вуліца 	Встречная улица 	вуліца
Сустрэчны завулак 	Встречный переулок 	завулак
Сухараўская вуліца 	Сухаревская улица 	вуліца
Сухая вуліца 	Сухая улица 	вуліца
Сцебянёва вуліца 	Стебенёва улица 	вуліца
Сцебянёва завулак 	Стебенёва переулок 	завулак
Сцяпянская вуліца 	Степянская улица 	вуліца
Сцяпянскі завулак 	Степянский переулок 	завулак
Сядзібная вуліца 	Усадебная улица 	вуліца
Сядзібны завулак 	Усадебный переулок 	завулак
Сядова вуліца 	Седова улица 	вуліца
Сядых вуліца 	Седых улица 	вуліца
Сяліцкага вуліца 	Селицкого улица 	вуліца
Сямашкі вуліца 	Семашко улица 	вуліца
Сямёнава вуліца 	Семёнова улица 	вуліца
Сяргея Ясеніна вуліца 	Сергея Есенина улица 	вуліца
Сярова вуліца 	Серова улица 	вуліца
Табольскі завулак 	Тобольский переулок 	завулак
Таварыскі завулак 	Товарищеский переулок 	завулак
Таежная вуліца 	Таёжная улица 	вуліца
Талаша 1-ы завулак 	Талаша 1-й переулок 	завулак
Талаша вуліца 	Талаша улица 	вуліца
Талбухіна вуліца 	Толбухина улица 	вуліца
Талінская вуліца 	Таллинская улица 	вуліца
Талінскі завулак 	Таллинский переулок 	завулак
Танкавая вуліца 	Танковая улица 	вуліца
Тапаграфічная вуліца 	Топографическая улица 	вуліца
Тапаграфічны 1-ы завулак 	Топографический 1-й переулок 	завулак
Тапаграфічны 2-і завулак 	Топографический 2-й переулок 	завулак
Тарханава вуліца 	Тарханова улица 	вуліца
Татарская вуліца 	Татарская улица 	вуліца
Ташкенцкая вуліца 	Ташкентская улица 	вуліца
Ташкенцкі праезд 	Ташкентский проезд 	праезд
Томская вуліца 	Томская улица 	вуліца
Томскі завулак 	Томский переулок 	завулак
Траецкая набярэжная 	Троицкая набережная 	набярэжная
Трактарабудаўнікоў бульвар 	Тракторостроителей бульвар 	бульвар
Трасцянецкая вуліца 	Тростенецкая улица 	вуліца
Трубны 1-ы завулак 	Трубный 1-й переулок 	завулак
Трубны 2-і завулак 	Трубный 2-й переулок 	завулак
Трубны 3-і завулак 	Трубный 3-й переулок 	завулак
Тульская вуліца 	Тульская улица 	вуліца
Тульскі 1-ы завулак 	Тульский 1-й переулок 	завулак
Тульскі 2-і завулак 	Тульский 2-й переулок 	завулак
Тупалева вуліца 	Туполева улица 	вуліца
Тупіковая вуліца 	Тупиковая улица 	вуліца
Тургенева вуліца 	Тургенева улица 	вуліца
Тухачэўскага вуліца 	Тухачевского улица 	вуліца
Тучынскі завулак 	Тучинский переулок 	завулак
Тыражная вуліца 	Тиражная улица 	вуліца
Тыражны 1-ы завулак 	Тиражный 1-й переулок 	завулак
Тыражны 2-і завулак 	Тиражный 2-й переулок 	завулак
Тыражны праезд 	Тиражный проезд 	праезд
Тышкевічаў вуліца 	Тышкевичей улица 	вуліца
Тэлеграфны завулак 	Телеграфный переулок 	завулак
Убарэвіча вуліца 	Уборевича улица 	вуліца
Узлётная вуліца 	Взлётная улица 	вуліца
Украінская вуліца 	Украинская улица 	вуліца
Уладзіміра Алоўнікава вуліца 	Владимира Оловникова улица 	вуліца
Уладзіміра Дубоўкі вуліца 	Владимира Дубовки улица 	вуліца
Уладзіслава Галубка вуліца 	Владислава Голубка улица 	вуліца
Уладзіслава Сыракомлі вуліца 	Владислава Сырокомли улица 	вуліца
Ульянаўская вуліца 	Ульяновская улица 	вуліца
Уманская 1-я вуліца 	Уманская 1-я улица 	вуліца
Уманская вуліца 	Уманская улица 	вуліца
Універсітэцкі праезд 	Университетский проезд 	праезд
Ураджайная вуліца 	Урожайная улица 	вуліца
Уральская вуліца 	Уральская улица 	вуліца
Уральскі завулак 	Уральский переулок 	завулак
Уруцкая вуліца 	Уручская улица 	вуліца
Усевалада Ігнатоўскага вуліца 	Всеволода Игнатовского улица 	вуліца
Усіхсвяцкая вуліца 	Всехсвятская улица 	вуліца
Усходні завулак 	Восточный переулок 	завулак
Усходняя вуліца 	Восточная улица 	вуліца
Утульная вуліца 	Утульная улица 	вуліца
Уфімская вуліца 	Уфимская улица 	вуліца
Ушакова вуліца 	Ушакова улица 	вуліца
Ушакова завулак 	Ушакова переулок 	завулак
Ушацкая вуліца 	Ушачская улица 	вуліца
Фабрыцыуса вуліца 	Фабрициуса улица 	вуліца
Фабрыцыуса завулак 	Фабрициуса переулок 	завулак
Фабрычная вуліца 	Фабричная улица 	вуліца
Фабрычны 1-ы завулак 	Фабричный 1-й переулок 	завулак
Фабрычны 2-і завулак 	Фабричный 2-й переулок 	завулак
Фальваркавы завулак 	Фольварковый переулок 	завулак
Фаміна 1-ы завулак 	Фомина 1-й переулок 	завулак
Фаміна 2-і завулак 	Фомина 2-й переулок 	завулак
Фаміна вуліца 	Фомина улица 	вуліца
Фаніпальская вуліца 	Фанипольская улица 	вуліца
Фаніпальскі завулак 	Фанипольский переулок 	завулак
Фердынанда Рушчыца вуліца 	Фердинанда Рущица улица 	вуліца
Фізкультурная вуліца 	Физкультурная улица 	вуліца
Фізкультурны 2-і завулак 	Физкультурный 2-й переулок 	завулак
Фізкультурны завулак 	Физкультурный переулок 	завулак
Філатава вуліца 	Филатова улица 	вуліца
Філімонава вуліца 	Филимонова улица 	вуліца
Фогеля вуліца 	Фогеля улица 	вуліца
Францішка Багушэвіча плошча 	Франтишка Богушевича площадь 	плошча
Францыска Скарыны 1-ы завулак 	Франциска Скорины 1-й переулок 	завулак
Францыска Скарыны вуліца 	Франциска Скорины улица 	вуліца
Фролікава вуліца 	Фроликова улица 	вуліца
Фрунзэ вуліца 	Фрунзе улица 	вуліца
Фучыка вуліца 	Фучика улица 	вуліца
Фядотава вуліца 	Федотова улица 	вуліца
Фядотава завулак 	Федотова переулок 	завулак
Хабараўская вуліца 	Хабаровская улица 	вуліца
Халмагорская вуліца 	Холмогорская улица 	вуліца
Халмагорскі 1-ы завулак 	Холмогорский 1-й переулок 	завулак
Халмагорскі 2-і завулак 	Холмогорский 2-й переулок 	завулак
Халмагорскі 3-і завулак 	Холмогорский 3-й переулок 	завулак
Халмагорскі 4-ы завулак 	Холмогорский 4-й переулок 	завулак
Халтурына 1-ы завулак 	Халтурина 1-й переулок 	завулак
Халтурына 2-і завулак 	Халтурина 2-й переулок 	завулак
Халтурына вуліца 	Халтурина улица 	вуліца
Харкаўская вуліца 	Харьковская улица 	вуліца
Харкаўскі 3-і завулак 	Харьковский 3-й переулок 	завулак
Хмарынская вуліца 	Хмаринская улица 	вуліца
Хмялеўскага вуліца 	Хмелевского улица 	вуліца
Хмяльніцкага вуліца 	Хмельницкого улица 	вуліца
Цвёрды 1-ы завулак 	Твёрдый 1-й переулок 	завулак
Цікоцкага вуліца 	Тикоцкого улица 	вуліца
Цімашэнкі 1-ы завулак 	Тимошенко 1-й переулок 	завулак
Цімашэнкі 2-і завулак 	Тимошенко 2-й переулок 	завулак
Цімашэнкі вуліца 	Тимошенко улица 	вуліца
Ціміразева вуліца 	Тимирязева улица 	вуліца
Ціхая вуліца 	Тихая улица 	вуліца
Ціхі завулак 	Тихий переулок 	завулак
Цнянская вуліца 	Цнянская улица 	вуліца
Цэнтральная вуліца 	Центральная улица 	вуліца
Цэнтральная плошча 	Центральная площадь 	плошча
Цяністая вуліца 	Тенистая улица 	вуліца
Цяпінскага вуліца 	Тяпинского улица 	вуліца
Цяплічная вуліца 	Тепличная улица 	вуліца
Цяплічны завулак 	Тепличный переулок 	завулак
Чабатарова вуліца 	Чеботарёва улица 	вуліца
Чайкоўскага вуліца 	Чайковского улица 	вуліца
Чайкоўскага завулак 	Чайковского переулок 	завулак
Чайкоўскага праезд 	Чайковского проезд 	праезд
Чайлыткі вуліца 	Чайлытко улица 	вуліца
Чакаліна вуліца 	Чекалина улица 	вуліца
Чакаліна праезд 	Чекалина проезд 	праезд
Чалюскінцаў 2-і завулак 	Челюскинцев 2-й переулок 	завулак
Чалюскінцаў вуліца 	Челюскинцев улица 	вуліца
Чапаева вуліца 	Чапаева улица 	вуліца
Чарвякова вуліца 	Червякова улица 	вуліца
Чарвякова завулак 	Червякова переулок 	завулак
Чарнігаўская вуліца 	Черниговская улица 	вуліца
Чарнігаўскі завулак 	Черниговский переулок 	завулак
Чарнышэўскага 1-ы завулак 	Чернышевского 1-й переулок 	завулак
Чарнышэўскага вуліца 	Чернышевского улица 	вуліца
Чарняхоўскага вуліца 	Черняховского улица 	вуліца
Чкалава вуліца 	Чкалова улица 	вуліца
Чурлёніса вуліца 	Чюрлёниса улица 	вуліца
Чыгладзэ вуліца 	Чигладзе улица 	вуліца
Чыгуначная вуліца 	Железнодорожная улица 	вуліца
Чыгуначны 1-ы завулак 	Железнодорожный 1-й переулок 	завулак
Чыгуначны 3-і завулак 	Железнодорожный 3-й переулок 	завулак
Чыгуначны 4-ы завулак 	Железнодорожный 4-й переулок 	завулак
Чыгуначны 5-ы завулак 	Железнодорожный 5-й переулок 	завулак
Чыгуначны 6-ы завулак 	Железнодорожный 6-й переулок 	завулак
Чыгуначны 7-ы завулак 	Железнодорожный 7-й переулок 	завулак
Чыгуначны 8-ы завулак 	Железнодорожный 8-й переулок 	завулак
Чыжоўская вуліца 	Чижовская улица 	вуліца
Чыжэўскіх вуліца 	Чижевских улица 	вуліца
Чыжэўскіх завулак 	Чижевских переулок 	завулак
Чыжэўскіх праезд 	Чижевских проезд 	праезд
Чырванадонская вуліца 	Краснодонская улица 	вуліца
Чырваназоркавая вуліца 	Краснозвёздная улица 	вуліца
Чырваназоркавы завулак 	Краснозвёздный переулок 	завулак
Чырвонаармейская вуліца 	Красноармейская улица 	вуліца
Чырвонаслабодская вуліца 	Краснослободская улица 	вуліца
Чырвоная вуліца 	Красная улица 	вуліца
Чырвоная Слабада вуліца 	Красная Слобода улица 	вуліца
Чычурына вуліца 	Чичурина улица 	вуліца
Чычэрына вуліца 	Чичерина улица 	вуліца
Чэхава вуліца 	Чехова улица 	вуліца
Шабаны вуліца 	Шабаны улица 	вуліца
Шаблоўскага вуліца 	Шабловского улица 	вуліца
Шаранговіча вуліца 	Шаранговича улица 	вуліца
Шасэйная вуліца 	Шоссейная улица 	вуліца
Шаўчэнкі бульвар 	Шевченко бульвар 	бульвар
Шафарнянская вуліца 	Шафарнянская улица 	вуліца
Шацілы вуліца 	Шатило улица 	вуліца
Шацько вуліца 	Шатько улица 	вуліца
Шкляны завулак 	Стекольный переулок 	завулак
Школьная вуліца 	Школьная улица 	вуліца
Школьны завулак 	Школьный переулок 	завулак
Шорная вуліца 	Шорная улица 	вуліца
Шостая Лінія 2-я вуліца 	Шестая Линия 2-я улица 	вуліца
Шпалерная вуліца 	Обойная улица 	вуліца
Шпалерны завулак 	Обойный переулок 	завулак
Шугаева вуліца 	Шугаева улица 	вуліца
Шумілінская вуліца 	Шумилинская улица 	вуліца
Шчадрына 1-ы завулак 	Щедрина 1-й переулок 	завулак
Шчадрына 2-і завулак 	Щедрина 2-й переулок 	завулак
Шчадрына 3-і завулак 	Щедрина 3-й переулок 	завулак
Шчадрына вуліца 	Щедрина улица 	вуліца
Шчарбакова вуліца 	Щербакова улица 	вуліца
Шчарбакова завулак 	Щербакова переулок 	завулак
Шчорса 2-я вуліца 	Щорса 2-я улица 	вуліца
Шчорса 3-я вуліца 	Щорса 3-я улица 	вуліца
Шчорса 4-я вуліца 	Щорса 4-я улица 	вуліца
Шчорса 5-я вуліца 	Щорса 5-я улица 	вуліца
Шчорса вуліца 	Щорса улица 	вуліца
Шчотаўка вуліца 	Щётовка улица 	вуліца
Шчукіна вуліца 	Щукина улица 	вуліца
Шчэпкіна вуліца 	Щепкина улица 	вуліца
Шырокая вуліца 	Широкая улица 	вуліца
Шышкіна вуліца 	Шишкина улица 	вуліца
Шэйпічы вуліца 	Шейпичи улица 	вуліца
Экскаватарная вуліца 	Экскаваторная улица 	вуліца
Экскаватарны завулак 	Экскаваторный переулок 	завулак
Энгельса вуліца 	Энгельса улица 	вуліца
Энергетычны праезд 	Энергетический проезд 	праезд
Юбілейная вуліца 	Юбилейная улица 	вуліца
Юбілейная плошча 	Юбилейная площадь 	плошча
Юбілейны завулак 	Юбилейный переулок 	завулак
Юнацкая вуліца 	Юношеская улица 	вуліца
Юнацкі 1-ы завулак 	Юношеский 1-й переулок 	завулак
Юнацкі 2-і завулак 	Юношеский 2-й переулок 	завулак
Юрава-Завальная вуліца 	Юрово-Завальная улица 	вуліца
Юрыя Семянякі вуліца 	Юрия Семеняко улица 	вуліца
Яблыневая вуліца 	Яблоневая улица 	вуліца
Язмінавая вуліца 	Жасминовая улица 	вуліца
Язэпа Драздовіча вуліца 	Язепа Дроздовича улица 	вуліца
Якуба Коласа вуліца 	Якуба Коласа улица 	вуліца
Якуба Коласа завулак 	Якуба Коласа переулок 	завулак
Якуба Коласа плошча 	Якуба Коласа площадь 	плошча
Якубава вуліца 	Якубова улица 	вуліца
Якубоўскага вуліца 	Якубовского улица 	вуліца
Яна Баршчэўскага вуліца 	Яна Борщевского улица 	вуліца
Яна Райніса вуліца 	Яна Райниса улица 	вуліца
Яна Чачота вуліца 	Яна Чечота улица 	вуліца
Янкі Брыля вуліца 	Янки Брыля улица 	вуліца
Янкі Купалы вуліца 	Янки Купалы улица 	вуліца
Янкі Лучыны вуліца 	Янки Лучины улица 	вуліца
Янкі Маўра вуліца 	Янки Мавра улица 	вуліца
Янкоўскага вуліца 	Янковского улица 	вуліца
Янтарная вуліца 	Янтарная улица 	вуліца
Янтарны завулак 	Янтарный переулок 	завулак
Ярашэвіцкая вуліца 	Ярошевичская улица 	вуліца
Ярашэвіцкі завулак 	Ярошевичский переулок 	завулак
Яркоўская вуліца 	Ярковская улица 	вуліца
Ясная вуліца 	Ясная улица 	вуліца
Яўгена Глебава вуліца 	Евгения Глебова улица 	вуліца
Яўгена Міркоўскага вуліца 	Евгения Мирковского улица 	вуліца